lr,lc,rc,ld,rd,lnnz,rnnz,lr*lc,lc*rc,lr*rc,lr*lc*rc,lr*lc+lc*rc,ld*rd,ld+rd,lr*rc*ld*rd,lr*lc*rc*ld*rd,lnnz*rnnz,lnnz+rnnz,lnnz+lc*rc,lr*lc+rnnz,sp_smdm,bz_smsm,bz_smdm
97366,33288,5958,0.00056263,0.13,1823595,25785518,3241119408,198329904,580106628,1.93E+13,3439449312,7.31E-05,1.31E-01,42430.10097,1412413201,4.70E+13,27609113,200153499,3266904926,32623,76241,73181
37277,6335,8305,0.00015297,0.2,36129,10524778,236149795,52612175,309585485,1.96E+12,288761970,3.06E-05,2.00E-01,9471.458328,60001688.51,3.80E+11,10560907,52648304,246674573,5402,4022,6577
122335,65522,2027,0.00041097,0.25,3294205,33216643,8015633870,132813094,247973045,1.62E+13,8148446964,0.000102743,2.50E-01,25477.37058,1669328275,1.09E+14,36510848,136107299,8048850513,31856,50312,47826
85283,55401,5954,1.65E-05,0.13,78006,42884765,4724763483,329857554,507774982,2.81E+13,5054621037,2.15E-06,1.30E-01,1089.837444,60378084.23,3.35E+12,42962771,329935560,4767648248,22248,5405,10935
88648,49392,11945,0.00296184,0.005,12968430,2949991,4378502016,589987440,1058900360,5.23E+13,4968489456,1.48E-05,7.96E-03,15681.46721,774539028.5,3.83E+13,15918421,602955870,4381452007,339996,53227,908915
78717,99615,6291,0.00015297,0.05,1199504,31338809,7841393955,626677965,495208647,4.93E+13,8468071920,7.65E-06,5.02E-02,3787.603337,377302106.4,3.76E+13,32538313,627877469,7872732764,20561,33460,67547
39049,43377,14025,0.00031941,0.03,541033,18252082,1693828473,608362425,547662225,2.38E+13,2302190898,9.58E-06,3.03E-02,5247.863739,227636585.4,9.87E+12,18793115,608903458,1712080555,25706,20547,56943
106348,17623,17965,0.00491597,0.13,9213441,41159621,1874170804,316597195,1910541820,3.37E+13,2190767999,0.000639076,1.35E-01,1220981.615,21517359005,3.79E+14,50373062,325810636,1915330425,450878,412629,1040685
58019,54547,17077,0.00108175,0.07,3423537,65207439,3164762393,931499119,990790463,5.40E+13,4096261512,7.57E-05,7.11E-02,75025.13083,4092395812,2.23E+14,68630976,934922656,3229969832,117021,167477,346210
126899,52210,12948,0.00182521,0.07,12092788,47322584,6625396790,676015080,1643088252,8.58E+13,7301411870,0.000127765,7.18E-02,209928.6776,10960376257,5.72E+14,59415372,688107868,6672719374,538814,309445,1095508
133764,1840,9040,0.00078778,0.15,193897,2495264,246125760,16633600,1209226560,2.22E+12,262759360,0.000118167,1.51E-01,142890.6749,262918841.8,4.84E+11,2689161,16827497,248621024,12577,18996,22902
132278,48224,8077,0.00047003,0.15,2998367,58429137,6378974272,389505248,1068409406,5.15E+13,6768479520,7.05E-05,1.50E-01,75327.67097,3632601605,1.75E+14,61427504,392503615,6437403409,91196,174315,179515
17639,14561,16707,0.00160539,0.13,412379,31628398,256841479,243270627,294694773,4.29E+12,500112106,0.000208701,1.32E-01,61503.00541,895545261.8,1.30E+13,32040777,243683006,288469877,23214,36391,40532
87003,95285,15346,0.00182521,5.00E-04,15131430,731149,8290080855,1462243610,1335148038,1.27E+14,9752324465,9.13E-07,2.33E-03,1218.462775,116101225.5,1.11E+13,15862579,1477375040,8290812004,518363,7771,1384577
122724,61616,2796,0.00031941,0.3,2415325,51698106,7561761984,172278336,343136304,2.11E+13,7734040320,9.58E-05,3.00E-01,32880.35006,2025955649,1.25E+14,54113431,174693661,7613460090,37265,65907,50682
74841,20268,16085,0.00047003,0.005,713008,1630128,1516877388,326010780,1203817485,2.44E+13,1842888168,2.35E-06,5.47E-03,2829.151662,57341245.89,1.16E+12,2343136,326723788,1518507516,28133,3420,78066
134987,39791,9266,0.00018467,0.13,991923,47932957,5371267717,368703406,1250789542,4.98E+13,5739971123,2.40E-05,1.30E-01,30027.82961,1194837368,4.75E+13,48924880,369695329,5419200674,43903,101564,94968
62177,74537,22036,0.00082487,0.001,3822919,1642560,4634487049,1642497332,1370132372,1.02E+14,6276984381,8.25E-07,1.82E-03,1130.18109,84240307.88,6.28E+12,5465479,1646320251,4636129609,142660,7235,477252
108666,10740,19512,0.00078778,0.17,919427,35627383,1167072840,209558880,2120290992,2.28E+13,1376631720,0.000133923,1.71E-01,283954.8824,3049675437,3.28E+13,36546810,210478307,1202700223,58888,188507,134550
68306,38201,16043,0.00082282,0.03,2147067,18386741,2609357506,612858643,1095833158,4.19E+13,3222216149,2.47E-05,3.08E-02,27050.20317,1033344811,3.95E+13,20533808,615005710,2627744247,65256,71795,203576
11006,60966,19826,0.00013363,0.03,89670,36262371,670991796,1208711916,218204956,1.33E+13,1879703712,4.01E-06,3.01E-02,874.7618481,53330730.83,3.25E+12,36352041,1208801586,707254167,16860,4244,25102
91522,11923,20111,0.01084252,5.00E-04,11831944,119900,1091216806,239783453,1840598942,2.19E+13,1331000259,5.42E-06,1.13E-02,9978.36542,118972050.9,1.42E+12,11951844,251615397,1091336706,537932,7852,1375666
71595,49258,560,0.00082185,0.13,2898403,3589833,3526626510,27584480,40093200,1.97E+12,3554210990,0.000106841,1.31E-01,4283.577535,211000462.2,1.04E+13,6488236,30482883,3530216343,3019,6040,9778
73287,5810,17923,0.00015297,0.3,65139,31243081,425797470,104132630,1313522901,7.63E+12,529930100,4.59E-05,3.00E-01,60278.87945,350220289.6,2.04E+12,31308220,104197769,457040551,23323,27410,26727
80348,24008,14712,2.48E-05,0.13,47897,45919803,1928994784,353205696,1182079776,2.84E+13,2282200480,3.23E-06,1.30E-01,3815.635309,91605772.5,2.20E+12,45967700,353253593,1974914587,29203,7599,35508
83116,9119,5696,0.00015297,0.2,115948,10389143,757934804,51941824,473428736,4.32E+12,809876628,3.06E-05,2.00E-01,14484.07875,132080314.1,1.20E+12,10505091,52057772,768323947,6610,12743,11635
29735,25167,22174,0.00082282,0.1,615772,55808823,748340745,558053058,659343890,1.66E+13,1306393803,8.23E-05,1.01E-01,54252.13396,1365363455,3.44E+13,56424595,558668830,804149568,24557,84354,83378
105970,16771,5723,0.01084252,0.2,19270355,19197223,1777222870,95980433,606466310,1.02E+13,1873203303,0.002168504,2.11E-01,1315124.619,22055954987,3.70E+14,38467578,115250788,1796420093,289737,206628,669562
53708,99995,1909,0.00018467,0.13,991788,24821230,5370531460,190890455,102528572,1.03E+13,5561421915,2.40E-05,1.30E-01,2461.413681,246129061,2.46E+13,25813018,191882243,5395352690,5212,11047,14326
9330,12165,12704,0.00860544,0.13,976794,20092750,113499450,154544160,118528320,1.44E+12,268043610,0.001118707,1.39E-01,132598.485,1613060570,1.96E+13,21069544,155520954,133592200,14372,20215,66162
49255,32636,13889,0.00491597,0.03,7902553,13599335,1607486180,453281404,684102695,2.23E+13,2060767584,0.000147479,3.49E-02,100890.8498,3292673773,1.07E+14,21501888,461183957,1621085515,178259,93289,577927
8481,44708,6048,0.00078778,0.23,298728,62197325,379168548,270393984,51293088,2.29E+12,649562532,0.000181189,2.31E-01,9293.763839,415505593.7,1.86E+13,62496053,270692712,441365873,5911,8077,13311
35773,24749,7821,0.00047003,0.17,416149,32907979,885345977,193561929,279780633,6.92E+12,1078907906,7.99E-05,1.70E-01,22355.89946,553286155.7,1.37E+13,33324128,193978078,918253956,16704,33173,21563
66341,87385,9302,1.65E-05,0.07,95713,56904020,5797208285,812855270,617103982,5.39E+13,6610063555,1.16E-06,7.00E-02,713.187072,62321852.29,5.45E+12,56999733,812950983,5854112305,33930,6221,40835
66173,57686,8764,0.00952101,0.13,36344782,65725864,3817255678,505560104,579940172,3.35E+13,4322815782,0.001237731,1.40E-01,717810.103,41407593602,2.39E+15,102070646,541904886,3882981542,494480,375822,1661037
7297,11850,43501,0.00160539,0.03,138831,15465088,86469450,515486850,317426797,3.76E+12,601956300,4.82E-05,3.16E-02,15287.81417,181160597.9,2.15E+12,15603919,515625681,101934538,15784,17138,23733
109258,67641,5832,0.00013363,0.13,987586,51286831,7390320378,394482312,637192656,4.31E+13,7784802690,1.74E-05,1.30E-01,11069.2471,748734943.1,5.07E+13,52274417,395469898,7441607209,36256,59694,49397
17199,84760,1995,0.00296184,0.03,4317875,5074350,1457787240,169096200,34312005,2.91E+12,1626883440,8.89E-05,3.30E-02,3048.800067,258416293.7,2.19E+13,9392225,173414075,1462861590,12606,5466,46731
9314,7419,13478,0.00163948,0.2,113298,20000240,69100566,99993282,125534092,9.31E+11,169093848,0.000327896,2.02E-01,41162.12663,305381817.5,2.27E+12,20113538,100106580,89100806,3179,17268,9750
43659,47194,33980,2.09E-05,0.03,43023,48110586,2060442846,1603652120,1483532820,7.00E+13,3664094966,6.26E-07,3.00E-02,929.2849584,43856674.33,2.07E+12,48153609,1603695143,2108553432,45903,4012,58407
14569,13356,16170,0.02533638,0.23,4930456,49677774,194583564,215966520,235580730,3.15E+12,410550084,0.005827367,2.55E-01,1372815.466,18335323365,2.45E+14,54608230,220896976,244261338,121426,131364,402422
34130,54768,3405,0.00370564,0.005,6926936,932440,1869231840,186485040,116212650,6.36E+12,2055716880,1.85E-05,8.71E-03,2153.211222,117927072.2,6.46E+12,7859376,193411976,1870164280,34513,6438,123200
82597,83646,2519,0.00013363,0.03,923240,6321702,6908908662,210704274,208061843,1.74E+13,7119612936,4.01E-06,3.01E-02,834.0991224,69769055.19,5.84E+12,7244942,211627514,6915230364,9988,5640,20928
69420,40962,10465,0.00952101,0.13,27074371,55732444,2843582040,428667330,726480300,2.98E+13,3272249370,0.001237731,1.40E-01,899187.4061,36832514530,1.51E+15,82806815,455741701,2899314484,477717,367858,1484124
46756,53769,7584,0.00160539,0.01,4036030,4078138,2514023364,407784096,354597504,1.91E+13,2921807460,1.61E-05,1.16E-02,5692.672869,306089327.5,1.65E+13,8114168,411820126,2518101502,50471,20217,169611
98966,87945,14688,0.00370564,5.00E-04,32252780,645897,8703564870,1291736160,1453612608,1.28E+14,9995301030,1.85E-06,4.21E-03,2693.282512,236860730.5,2.08E+13,32898677,1323988940,8704210767,1176893,20294,2889740
16232,10652,12684,0.00182521,0.05,315616,6756092,172903264,135109968,205886688,2.19E+12,308013232,9.13E-05,5.18E-02,18789.32209,200143858.9,2.13E+12,7071708,135425584,179659356,9375,13849,26545
116115,98118,11052,0.00031941,0.05,3639059,54223806,11392971570,1084400136,1283302980,1.26E+14,12477371706,1.60E-05,5.03E-02,20494.99024,2010927453,1.97E+14,57862865,1088039195,11447195376,131108,150395,335026
66177,6349,17332,0.00952101,0.1,4000474,11004602,420157773,110040868,1146979764,7.28E+12,530198641,0.000952101,1.10E-01,1092040.58,6933365644,4.40E+13,15005076,114041342,431162375,117138,158641,373265
64050,5188,31464,0.00013363,0.13,44408,21222444,332291400,163235232,2015269200,1.05E+13,495526632,1.74E-05,1.30E-01,35009.05502,181626977.4,9.42E+11,21266852,163279640,353513844,25896,17247,35953
110661,20042,1144,0.00031941,0.23,708415,5275053,2217867762,22928048,126596184,2.54E+12,2240795810,7.35E-05,2.30E-01,9300.30004,186396613.4,3.74E+12,5983468,23636463,2223142815,3864,12804,6871
106078,18553,6299,0.00018467,0.17,363448,19870443,1968065134,116865347,668185322,1.24E+13,2084930481,3.14E-05,1.70E-01,20976.94318,389185226.8,7.22E+12,20233891,117228795,1987935577,16240,30888,29729
95437,99103,2109,0.00296184,0.25,28013575,52252550,9458093011,209008227,201276633,1.99E+13,9667101238,0.00074046,2.53E-01,149037.2957,14770043113,1.46E+15,80266125,237021802,9510345561,156278,155610,349853
31526,11513,45258,0.00182521,0.07,662517,36475921,362958838,521055354,1426803708,1.64E+13,884014192,0.000127765,7.18E-02,182295.1477,2098764036,2.42E+13,37138438,521717871,399434759,60132,123332,182304
78312,23565,7906,0.00015297,0.3,282301,55892512,1845422280,186304890,619134672,1.46E+13,2031727170,4.59E-05,3.00E-01,28412.70923,669545493.1,1.58E+13,56174813,186587191,1901314792,27884,49600,20260
34422,86478,23247,0.00163948,5.00E-04,4880418,1005186,2976745716,2010354066,800208234,6.92E+13,4987099782,8.20E-07,2.14E-03,655.9626977,56726342.18,4.91E+12,5885604,2015234484,2977750902,179926,3565,620209
76873,97636,16492,0.00370564,0.03,27813025,48309209,7505572228,1610212912,1267789516,1.24E+14,9115785140,0.000111169,3.37E-02,140939.1463,13760734484,1.34E+15,76122234,1638025937,7553881437,758392,275059,2508700
32360,2665,45187,0.00031941,0.07,27555,8432644,86239400,120423355,1462251320,3.90E+12,206662755,2.24E-05,7.03E-02,32694.03859,87129612.84,2.32E+11,8460199,120450910,94672044,15278,8023,23679
147394,27458,5779,0.00041097,0.2,1663311,31738071,4047144452,158679782,851789926,2.34E+13,4205824234,8.22E-05,2.00E-01,70012.02118,1922390077,5.28E+13,33401382,160343093,4078882523,37904,111812,75733
56692,88821,2138,0.00860544,0.2,43333045,37984798,5035440132,189899298,121207496,1.08E+13,5225339430,0.001721088,2.09E-01,208608.7669,18528839283,1.65E+15,81317843,233232343,5073424930,141707,137663,478550
70273,19995,29949,0.00056263,0.005,790577,2994283,1405108635,598830255,2104606077,4.21E+13,2003938890,2.81E-06,5.56E-03,5920.572586,118381848.8,2.37E+12,3784860,599620832,1408102918,52735,9217,155576
17525,66539,8771,0.00031941,0.03,372484,17509862,1166095975,583613569,153711775,1.02E+13,1749709544,9.58E-06,3.03E-02,1472.912342,98006114.3,6.52E+12,17882346,583986053,1183605837,12275,6741,26041
1009,17035,19372,0.00296184,0.17,50953,56103796,17188315,330002020,19546348,3.33E+11,347190335,0.000503513,1.73E-01,9841.836411,167655683.3,2.86E+12,56154749,330052973,73292111,5723,3722,8607
6600,8834,39569,0.00015297,0.13,8920,45445522,58304400,349552546,261155400,2.31E+12,407856946,1.99E-05,1.30E-01,5193.3624,45878163.44,4.05E+11,45454442,349561466,103749922,3843,3418,24097
92509,84398,3068,0.00370564,0.13,28932221,33670638,7807574582,258933064,283817612,2.40E+13,8066507646,0.000481733,1.34E-01,136724.3664,11539263079,9.74E+14,62602859,287865285,7841245220,227271,138693,531111
139925,7761,5943,0.00182521,0.2,1982194,9226373,1085957925,46123623,831574275,6.45E+12,1132081548,0.000365042,2.02E-01,303559.5365,2355925563,1.83E+13,11208567,48105817,1095184298,32392,98226,85717
99742,15952,1883,0.01084252,0.2,17252080,6010094,1591084384,30037616,187814186,3.00E+12,1621122000,0.002168504,2.11E-01,407275.8136,6496863779,1.04E+14,23262174,47289696,1597094478,77389,63084,195418
8213,29864,12338,0.00860544,0.1,2110867,36848979,245273032,368462032,101331994,3.03E+12,613735064,0.000860544,1.09E-01,87200.63944,2604159896,7.78E+13,38959846,370572899,282122011,31597,26626,137046
148295,70586,10233,8.43E-05,0.07,882313,50562229,10467550870,722306538,1517502735,1.07E+14,11189857408,5.90E-06,7.01E-02,8953.721387,632007377.8,4.46E+13,51444542,723188851,10518113099,53066,81853,106411
79098,33153,27005,0.00296184,0.03,7767106,26859588,2622335994,895296765,2136041490,7.08E+13,3517632759,8.89E-05,3.30E-02,189798.3938,6292386150,2.09E+14,34626694,903063871,2649195582,375972,258493,1155489
88999,13706,10833,0.01084252,5.00E-04,13226192,74244,1219820294,148477098,964126167,1.32E+13,1368297392,5.42E-06,1.13E-02,5226.778624,71638227.82,9.82E+11,13300436,161703290,1219894538,312668,3125,822523
145855,29838,5432,0.00034241,0.27,1490188,43763326,4352021490,162080016,792284360,2.36E+13,4514101506,9.25E-05,2.70E-01,73247.24368,2185551257,6.52E+13,45253514,163570204,4395784816,37058,111561,65790
96800,66343,67,0.00491597,0.25,31570600,1117164,6422002400,4444981,6485600,4.30E+11,6426447381,0.001228993,2.55E-01,7970.753758,528803716.6,3.53E+13,32687764,36015581,6423119564,5669,5305,13463
43568,87023,12162,0.00370564,0.005,14049825,5292307,3791418064,1058373726,529874016,4.61E+13,4849791790,1.85E-05,8.71E-03,9817.611743,854358026.7,7.44E+13,19342132,1072423551,3796710371,265570,52623,898034
141319,77728,4482,0.00296184,0.05,32534593,17419100,10984443232,348376896,633391758,4.92E+13,11332820128,0.000148092,5.30E-02,93800.25223,7290906005,5.67E+14,49953693,380911489,11001862332,517638,154983,1035063
4614,77191,1977,0.01084252,0.17,3862101,25955135,356159274,152606607,9121878,7.04E+11,508765881,0.001843228,1.81E-01,16813.70459,1297866671,1.00E+14,29817236,156468708,382114409,10540,10112,40826
149498,24663,3553,0.00056263,0.15,2074507,13144557,3687069174,87627639,531166394,1.31E+13,3774696813,8.44E-05,1.51E-01,44827.52224,1105581181,2.73E+13,15219064,89702146,3700213731,23376,63658,57461
137841,16598,5004,0.00182521,0.23,4176065,19105917,2287884918,83056392,689756364,1.14E+13,2370941310,0.000419798,2.32E-01,289558.549,4806092797,7.98E+13,23281982,87232457,2306990835,73356,124723,152258
87906,15292,10524,0.00860544,0.15,11568360,24140834,1344258552,160933008,925122744,1.41E+13,1505191560,0.001290816,1.59E-01,1194163.24,18261144265,2.79E+14,35709194,172501368,1368399386,264982,254112,696417
115721,77929,1260,0.00019487,0.15,1757358,14735341,9018021809,98190540,145808460,1.14E+13,9116212349,2.92E-05,1.50E-01,4262.05419,332137621,2.59E+13,16492699,99947898,9032757150,5965,18148,17815
145403,12494,13366,0.00952101,0.05,17296615,8350087,1816665082,166994804,1943456498,2.43E+13,1983659886,0.000476051,5.95E-02,925183.4376,11559241869,1.44E+14,25646702,184291419,1825015169,724115,296666,1588258
54821,11573,4809,0.00860544,0.15,5459856,8349149,634443433,55654557,263634189,3.05E+12,690097990,0.001290816,1.59E-01,340303.2293,3938329273,4.56E+13,13809005,61114413,642792582,42089,49837,137065
28436,5810,37630,0.00952101,0.13,1573159,28424557,165213160,218630300,1070046680,6.22E+12,383843460,0.001237731,1.40E-01,1324430.268,7694939859,4.47E+13,29997716,220203459,193637717,80272,154166,310728
94130,40069,19510,0.00018467,0.07,696528,54724088,3771694970,781746190,1836476300,7.36E+13,4553441160,1.29E-05,7.02E-02,23739.94548,951235875.5,3.81E+13,55420616,782442718,3826419058,59630,80462,130979
44963,93459,20068,0.01084252,0.005,45563041,9377768,4202197017,1875535212,902317484,8.43E+13,6077732229,5.42E-05,1.58E-02,48916.97683,4571731738,4.27E+14,54940809,1921098253,4211574785,1373875,127754,4720649
99321,47329,4093,0.00163948,0.17,7707002,32939353,4700763609,193717597,406520853,1.92E+13,4894481206,0.000278712,1.72E-01,113302.0774,5362474020,2.54E+14,40646355,201424599,4733702962,92154,107355,201379
22290,3628,41455,0.00056263,0.27,45499,40608411,80868120,150398740,924031950,3.35E+12,231266860,0.00015191,2.71E-01,140369.7859,509261583.3,1.85E+12,40653910,150444239,121476531,23056,44552,19101
37323,42190,40215,0.00860544,0.03,13550901,50900603,1574657370,1696670850,1500944445,6.33E+13,3271328220,0.000258163,3.86E-02,387488.6209,16348144918,6.90E+14,64451504,1710221751,1625557973,831271,242055,2903080
70266,23925,8549,0.00182521,0.23,3068395,47046079,1681114050,204534825,600704034,1.44E+13,1885648875,0.000419798,2.32E-01,252174.5323,6033275685,1.44E+14,50114474,207603220,1728160129,61616,135220,152603
108176,10277,16847,0.02533638,0.01,28169438,1731551,1111724752,173136619,1822441072,1.87E+13,1284861371,0.000253364,3.53E-02,461740.5953,4745308098,4.88E+13,29900989,201306057,1113456303,1046768,195786,1219710
45554,44248,4608,0.00370564,0.23,7469617,46903538,2015673392,203894784,209912832,9.29E+12,2219568176,0.000852297,2.34E-01,178908.119,7916326448,3.50E+14,54373155,211364401,2062576930,74242,80066,195790
63185,35864,30908,0.00034241,0.05,775950,55426907,2266066840,1108484512,1952921980,7.00E+13,3374551352,1.71E-05,5.03E-02,33435.00076,1199112867,4.30E+13,56202857,1109260462,2321493747,75389,104589,180799
39684,35674,39856,0.02533638,5.00E-04,35870059,710931,1415687016,1421822944,1581645504,5.64E+13,2837509960,1.27E-05,2.58E-02,20036.58576,714785160.3,2.55E+13,36580990,1457693003,1416397947,2049867,44884,7503112
145742,7273,5457,0.00041097,0.15,435646,5954690,1059981566,39688761,795314094,5.78E+12,1099670327,6.16E-05,1.50E-01,49027.53498,356577261.9,2.59E+12,6390336,40124407,1065936256,11524,27591,24668
104687,62677,694,0.00031941,0.15,2095829,6529094,6561467099,43497838,72652778,4.55E+12,6604964937,4.79E-05,1.50E-01,3480.903573,218172593.3,1.37E+13,8624923,45593667,6567996193,3692,9602,11534
48661,61929,2487,0.00047003,0.1,1416474,15405282,3013527069,154017423,121019907,7.49E+12,3167544492,4.70E-05,1.00E-01,5688.298689,352270649.5,2.18E+13,16821756,155433897,3028932351,6383,18750,22355
104636,18989,7540,0.00034241,0.15,680376,21477432,1986933004,143177060,788955440,1.50E+13,2130110064,5.14E-05,1.50E-01,40521.93483,769471020.5,1.46E+13,22157808,143857436,2008410436,23942,63377,45176
15239,2305,16071,0.00952101,0.23,334514,8522074,35125895,37043655,244905969,5.65E+11,72169550,0.002189832,2.40E-01,536303.0014,1236178418,2.85E+12,8856588,37378169,43647969,9024,27148,29781
38625,18083,33855,0.00182521,0.03,1274885,18366819,698455875,612199965,1307649375,2.36E+13,1310655840,5.48E-05,3.18E-02,71602.04147,1294779716,2.34E+13,19641704,613474850,716822694,72861,89916,250530
99120,5167,1758,0.00182521,0.15,934917,1362866,512153040,9083586,174252960,9.00E+11,521236626,0.000273782,1.52E-01,47707.23677,246503292.4,1.27E+12,2297783,10018503,513515906,4727,14781,12013
127421,28581,11899,0.00082185,0.2,2993060,68021844,3641819601,340085319,1516182479,4.33E+13,3981904920,0.00016437,2.01E-01,249214.9141,7122811459,2.04E+14,71014904,343078379,3709841445,125348,274334,268603
5977,61918,23382,0.00860544,0.03,3185260,43435153,370083886,1447766676,139754214,8.65E+12,1817850562,0.000258163,3.86E-02,36079.3951,2233963986,1.38E+14,46620413,1450951936,413519039,103455,31954,407728
28622,6023,25782,0.00056263,0.17,97005,26401930,172390306,155284986,737932404,4.44E+12,327675292,9.56E-05,1.71E-01,70581.09444,425109931.8,2.56E+12,26498935,155381991,198792236,18654,33049,26952
35424,35266,7029,0.00018467,0.03,230702,7437151,1249262784,247884714,248995296,8.78E+12,1497147498,5.54E-06,3.02E-02,1379.458839,48647995.43,1.72E+12,7667853,248115416,1256699935,9904,3588,16525
13856,26984,16641,0.00491597,0.005,1838207,2245358,373890304,449040744,230577696,6.22E+12,822931048,2.46E-05,9.92E-03,5667.565181,152933578.8,4.13E+12,4083565,450878951,376135662,39979,10679,169514
73949,38630,8852,0.00047003,0.15,1342750,51297811,2856649870,341952760,654596548,2.53E+13,3198602630,7.05E-05,1.50E-01,46152.00232,1782851850,6.89E+13,52640561,343295510,2907947681,44968,89912,75818
124497,22197,8624,0.01084252,0.15,29963611,28716034,2763459909,191426928,1073662128,2.38E+13,2954886837,0.001626378,1.61E-01,1746180.464,38759967769,8.60E+14,58679645,221390539,2792175943,756963,490478,1760519
11974,96365,2108,0.00082185,0.1,948369,20321664,1153874510,203137420,25241192,2.43E+12,1357011930,8.22E-05,1.01E-01,2074.447365,199904120.3,1.93E+13,21270033,204085789,1174196174,5377,4281,13501
113741,52296,7952,4.64E-06,0.13,27600,54062954,5948199336,415857792,904468432,4.73E+13,6364057128,6.03E-07,1.30E-01,545.5753582,28531408.93,1.49E+12,54090554,415885392,6002262290,31803,3114,37494
62475,50142,11853,0.00108175,0.05,3388772,29718924,3132621450,594333126,740516175,3.71E+13,3726954576,5.41E-05,5.11E-02,40052.66862,2008320910,1.01E+14,33107696,597721898,3162340374,80268,106456,241329
86495,75793,20085,0.00182521,5.00E-04,11965655,761169,6555715535,1522302405,1737252075,1.32E+14,8078017940,9.13E-07,2.33E-03,1585.42493,120164111.7,9.11E+12,12726824,1534268060,6556476704,528523,10871,1460959
60740,33953,7347,0.00015297,0.27,315475,67355810,2062305220,249452691,446256780,1.52E+13,2311757911,4.13E-05,2.70E-01,18431.2529,625796329.8,2.12E+13,67671285,249768166,2129661030,33219,34511,38176
134395,43005,4828,2.09E-05,0.25,120680,51907729,5779656975,207628140,648859060,2.79E+13,5987285115,5.22E-06,2.50E-01,3387.044293,145659839.8,6.26E+12,52028409,207748820,5831564704,25594,23945,20076
142067,99650,3320,0.00041097,0.13,5818115,43014289,14156976550,330838000,471662440,4.70E+13,14487814550,5.34E-05,1.30E-01,25199.08469,2511088789,2.50E+14,48832404,336656115,14199990839,85335,89320,156235
91878,79011,1585,0.00047003,0.3,3412190,37577321,7259372658,125232435,145626630,1.15E+13,7384605093,0.000141009,3.00E-01,20534.66547,1622464453,1.28E+14,40989511,128644625,7296949979,12034,31053,35166
148744,14195,4049,0.00082185,0.25,1735369,14372376,2111421080,57475555,602264456,8.55E+12,2168896635,0.000205463,2.51E-01,123742.7608,1756528489,2.49E+13,16107745,59210924,2125793456,21401,79891,53723
51691,40676,21979,0.00491597,5.00E-04,10336477,447028,2102583116,894017804,1136116489,4.62E+13,2996600920,2.46E-06,5.42E-03,2792.557288,113590060.3,4.62E+12,10783505,904354281,2103030144,357254,8025,1185490
131355,2093,9379,0.00952101,0.03,2617806,588994,274926015,19630247,1231978545,2.58E+12,294556262,0.00028563,3.95E-02,351890.4014,736506610.1,1.54E+12,3206800,22248053,275515009,58983,44833,165750
23823,4098,31372,0.00082185,0.13,80255,16717387,97626654,128562456,747375156,3.06E+12,226189110,0.000106841,1.31E-01,79849.93535,327225035.1,1.34E+12,16797642,128642711,114344041,14660,25260,24623
79806,43266,11330,0.00160539,0.13,5543327,63733088,3452886396,490203780,904201980,3.91E+13,3943090176,0.000208701,1.32E-01,188707.5862,8164622423,3.53E+14,69276415,495747107,3516619484,139780,203480,357598
134593,43061,8367,0.00108175,0.13,6269567,46841184,5795709173,360291387,1126139631,4.85E+13,6156000560,0.000140628,1.31E-01,158366.201,6819406979,2.94E+14,53110751,366560954,5842550357,188265,205587,378241
1845,30962,44492,0.00952101,0.005,544057,6888066,57124890,1377561304,82087740,2.54E+12,1434686194,4.76E-05,1.45E-02,3907.790967,120993023.9,3.75E+12,7432123,1378105361,64012956,41238,5525,141780
41847,20929,6892,0.00491597,0.1,4305644,14424885,875815863,144242668,288409524,6.04E+12,1020058531,0.000491597,1.05E-01,141781.2568,2967339923,6.21E+13,18730529,148548312,890240748,50113,43913,155025
41029,74071,14479,0.00491597,0.03,14940441,32175416,3039059059,1072474009,594058891,4.40E+13,4111533068,0.000147479,3.49E-02,87611.27059,6489454424,4.81E+14,47115857,1087414450,3071234475,324280,98583,1135680
47220,24989,19836,0.02533638,0.05,29897665,24784903,1179980580,495681804,936655920,2.34E+13,1675662384,0.001266819,7.53E-02,1186573.516,29651285589,7.41E+14,54682568,525579469,1204765483,881988,266948,3006991
118043,87390,12550,0.00182521,5.00E-04,18828527,548385,10315777770,1096744500,1481439650,1.29E+14,11412522270,9.13E-07,2.33E-03,1351.969232,118148591.2,1.03E+13,19376912,1115573027,10316326155,706167,7686,1589000
83322,26300,2170,0.00491597,0.25,10773141,14271019,2191368600,57071000,180808740,4.76E+12,2248439600,0.001228993,2.55E-01,222212.5854,5844190996,1.54E+14,25044160,67844141,2205639619,48066,69791,133094
17336,18634,23391,0.00078778,0.1,254495,43587966,323039024,435867894,405506376,7.56E+12,758906918,7.88E-05,1.01E-01,31944.98129,595262781.3,1.11E+13,43842461,436122389,366626990,28449,38387,39233
64413,10721,10525,0.00031941,0.03,220582,3385353,690571773,112838525,677946825,7.27E+12,803410298,9.58E-06,3.03E-02,6496.289861,69646723.6,7.47E+11,3605935,113059107,693957126,10179,4762,21088
75825,41469,9371,0.00034241,0.13,1076679,50521505,3144386925,388605999,710556075,2.95E+13,3532992924,4.45E-05,1.30E-01,31629.19573,1311631118,5.44E+13,51598184,389682678,3194908430,38378,89502,66745
109046,21660,1643,0.00163948,0.03,3872500,1067990,2361936360,35587380,179162578,3.88E+12,2397523740,4.92E-05,3.16E-02,8812.003901,190868004.5,4.14E+12,4940490,39459880,2363004350,17736,13104,43850
117887,43943,2704,0.00015297,0.17,792452,20207540,5180308441,118821872,318766448,1.40E+13,5299130313,2.60E-05,1.70E-01,8289.489604,364265041.7,1.60E+13,20999992,119614324,5200515981,14462,29899,18511
117867,21275,9275,0.00018467,0.13,463104,25653800,2507620425,197325625,1093216425,2.33E+13,2704946050,2.40E-05,1.30E-01,26244.95604,558361439.7,1.19E+13,26116904,197788729,2533274225,24610,45113,49129
137034,91065,2431,2.09E-05,0.27,260563,59785667,12479001210,221379015,333129654,3.03E+13,12700380225,5.64E-06,2.70E-01,1878.051737,171024781.5,1.56E+13,60046230,221639578,12538786877,29664,13050,21612
144112,87176,13029,0.00082487,0.05,10363023,56795187,12563107712,1135816104,1877635248,1.64E+14,13698923816,4.12E-05,5.08E-02,77440.24935,6750931177,5.89E+14,67158210,1146179127,12619902899,509582,303187,1050434
22530,10253,48658,0.00160539,0.03,370866,14967638,231000090,498890474,1096264740,1.12E+13,729890564,4.82E-05,3.16E-02,52797.97353,541337622.6,5.55E+12,15338504,499261340,245967728,36691,38712,112109
26419,12879,25452,0.00056263,0.1,191449,32781952,340250301,327796308,672416388,8.66E+12,668046609,5.63E-05,1.01E-01,37832.16324,487240430.3,6.28E+12,32973401,327987757,373032253,24685,36210,40757
40505,12378,27829,0.00041097,0.2,206065,68898718,501370890,344467362,1127213645,1.40E+13,845838252,8.22E-05,2.00E-01,92650.19834,1146824155,1.42E+13,69104783,344673427,570269608,42474,80420,25462
77031,584,19909,0.00491597,0.3,221416,3492264,44986104,11626856,1533610179,8.96E+11,56612960,0.001474791,3.05E-01,2261754.489,1320864622,7.73E+11,3713680,11848272,48478368,17807,67919,34985
46389,21677,12584,0.00082185,0.17,826472,46376622,1005574353,272783368,583759176,1.27E+13,1278357721,0.000139715,1.71E-01,81559.6214,1767967913,3.83E+13,47203094,273609840,1051950975,34539,74011,62307
88987,57897,16601,2.48E-05,0.03,127927,28835533,5152080339,961148097,1477273187,8.55E+13,6113228436,7.45E-07,3.00E-02,1100.420797,63711062.88,3.69E+12,28963460,961276024,5180915872,37294,5342,49450
74393,61781,3466,0.00182521,0.23,8388939,49256590,4596073933,214132946,257846138,1.59E+13,4810206879,0.000419798,2.32E-01,108243.3704,6687383666,4.13E+14,57645529,222521885,4645330523,71328,93399,157782
70243,18581,15137,0.00056263,0.13,734374,36566022,1305185183,281260597,1063268291,1.98E+13,1586445780,7.31E-05,1.31E-01,77769.46301,1445034392,2.69E+13,37300396,281994971,1341751205,38609,88137,77433
99551,65462,1370,0.00860544,0.15,56081368,13457341,6516807562,89682940,136384870,8.93E+12,6606490502,0.001290816,1.59E-01,176047.7724,11524439274,7.55E+14,69538709,145764308,6530264903,185531,116223,472963
101995,21211,15495,0.00018467,0.15,399527,49303159,2163415945,328664445,1580412525,3.35E+13,2492080390,2.77E-05,1.50E-01,43778.21715,928579763.9,1.97E+13,49702686,329063972,2212719104,43004,78032,65043
29391,45554,31508,0.00163948,0.001,2195076,1435322,1338877614,1435315432,926051628,4.22E+13,2774193046,1.64E-06,2.64E-03,1518.243123,69162047.23,3.15E+12,3630398,1437510508,1340312936,100695,3973,382150
105828,74577,396,0.00056263,0.2,4440503,5911526,7892334756,29532492,41907888,3.13E+12,7921867248,0.000112526,2.01E-01,4715.727005,351684772.9,2.63E+13,10352029,33972995,7898246282,4464,7926,12497
53857,9873,23597,0.00160539,0.13,853679,30288539,531730161,232973181,1270863629,1.25E+13,764703342,0.000208701,1.32E-01,265230.129,2618617063,2.59E+13,31142218,233826860,562018700,45500,127934,118489
46060,31593,12477,0.00296184,0.15,4310071,59129895,1455173580,394185861,574690620,1.82E+13,1849359441,0.000444276,1.53E-01,255321.2499,8066364248,2.55E+14,63439966,398495932,1514303475,105406,121873,284582
60528,5350,3159,0.00182521,0.23,591139,3888820,323824800,16900650,191207952,1.02E+12,340725450,0.000419798,2.32E-01,80268.7732,429437936.6,2.30E+12,4479959,17491789,327713620,4707,18552,13005
88725,62419,9675,0.00952101,0.05,52729591,30197769,5538125775,603903825,858414375,5.36E+13,6142029600,0.000476051,5.95E-02,408648.5924,25507436491,1.59E+15,82927360,656633416,5568323544,1133087,334234,2927142
141148,75771,13011,0.00160539,0.05,17169578,49293225,10694925108,985856481,1836476628,1.39E+14,11680781589,8.03E-05,5.16E-02,147413.0607,11169635022,8.46E+14,66462803,1003026059,10744218333,827216,351382,1647627
30866,17183,18656,0.00078778,0.05,417827,16028511,530370478,320566048,575836096,9.89E+12,850936526,3.94E-05,5.08E-02,22681.60799,389738070,6.70E+12,16446338,320983875,546398989,21655,29220,54496
81106,27977,18993,0.00013363,0.13,303222,69078256,2269102562,531367161,1540446258,4.31E+13,2800469723,1.74E-05,1.30E-01,26760.47835,748677902.8,2.09E+13,69381478,531670383,2338180818,49948,76537,79298
47902,10258,40635,0.00860544,0.07,4228743,29180178,491378716,416833830,1946497770,2.00E+13,908212546,0.000602381,7.86E-02,1172532.884,12027842323,1.23E+14,33408921,421062573,520558894,263526,262452,895875
64348,19672,7712,0.00370564,0.2,4690976,30345813,1265853856,151710464,496251776,9.76E+12,1417564320,0.000741128,2.04E-01,367786.0862,7235087889,1.42E+14,35036789,156401440,1296199669,69520,110950,193783
8093,11670,43230,0.00078778,0.07,74402,35315373,94445310,504494100,349860390,4.08E+12,598939410,5.51E-05,7.08E-02,19292.91126,225148274.4,2.63E+12,35389775,504568502,129760683,24349,13571,24778
70750,40157,28409,8.43E-05,0.03,239480,34225737,2841107750,1140820213,2009936750,8.07E+13,3981927963,2.53E-06,3.01E-02,5082.52706,204099039.1,8.20E+12,34465217,1141059693,2875333487,50324,16552,84519
20235,42466,12237,0.00182521,0.03,1568424,15590396,859299510,519656442,247615695,1.05E+13,1378955952,5.48E-05,3.18E-02,13558.51928,575776079.7,2.45E+13,17158820,521224866,874889906,28007,26522,114418
81521,33249,22127,0.01084252,5.00E-04,29389118,367856,2710491729,735700623,1803815167,6.00E+13,3446192352,5.42E-06,1.13E-02,9778.951012,325140342.2,1.08E+13,29756974,765089741,2710859585,1140998,26869,3486157
138381,26832,9184,0.00018467,0.27,685694,66541578,3713038992,246425088,1270891104,3.41E+13,3959464080,4.99E-05,2.70E-01,63367.77425,1700284119,4.56E+13,67227272,247110782,3779580570,43440,125825,58298
19306,38528,22318,0.00041097,0.05,305707,42994698,743821568,859867904,430871308,1.66E+13,1603689472,2.05E-05,5.04E-02,8853.759072,341117629.5,1.31E+13,43300405,860173611,786816266,21194,30542,49972
61507,64168,3007,0.00013363,0.13,527416,25087802,3946781176,192953176,184951549,1.19E+13,4139734352,1.74E-05,1.30E-01,3212.959814,206169205.3,1.32E+13,25615218,193480592,3971868978,5236,13013,13536
110118,17517,11225,8.43E-05,0.25,162597,49161767,1928937006,196628325,1236074550,2.17E+13,2125565331,2.11E-05,2.50E-01,26047.18095,456268468.8,7.99E+12,49324364,196790922,1978098773,30558,40129,36449
22950,10175,25162,0.00296184,0.27,691700,69132631,233516250,256023350,577467900,5.88E+12,489539600,0.000799697,2.73E-01,461799.2317,4698807183,4.78E+13,69824331,256715050,302648881,47689,92847,96421
39045,50871,3696,0.00082282,0.25,1634351,47005874,1986258195,188019216,144310320,7.34E+12,2174277411,0.000205705,2.51E-01,29685.35438,1510123662,7.68E+13,48640225,189653567,2033264069,9559,32010,34758
13984,6161,15339,0.00860544,0.3,741545,28355267,86155424,94503579,214500576,1.32E+12,180659003,0.002581632,3.09E-01,553761.551,3411724916,2.10E+13,29096812,95245124,114510691,24123,36579,59510
61837,15728,14842,0.02533638,0.13,24642471,30348225,972572336,233434976,917784754,1.44E+13,1206007312,0.003293729,1.55E-01,3022934.627,47544715815,7.48E+14,54990696,258077447,1002920561,557502,415586,1869468
47667,89081,10811,0.00491597,0.01,20874712,9631434,4246224027,963054691,515327937,4.59E+13,5209278718,4.92E-05,1.49E-02,25333.36678,2256721647,2.01E+14,30506146,983929403,4255855461,347351,69247,1168238
55938,9379,9133,0.00018467,0.15,96888,12849645,524642502,85658407,510881754,4.79E+12,610300909,2.77E-05,1.50E-01,14151.68003,132728607,1.24E+12,12946533,85755295,537492147,7758,13500,13397
145291,29857,2164,0.00015297,0.25,663593,16158835,4337953387,64610548,314409724,9.39E+12,4402563935,3.82E-05,2.50E-01,12023.81387,358995010.7,1.07E+13,16822428,65274141,4354112222,8402,27333,13778
73450,28696,2701,0.00296184,0.17,6242903,13178472,2107721200,77507896,198388450,5.69E+12,2185229096,0.000503513,1.73E-01,99891.12395,2866475693,8.23E+13,19421375,83750799,2120899672,29427,47884,93451
13678,69478,997,0.00370564,0.13,3521622,9012222,950320084,69269566,13636966,9.47E+11,1019589650,0.000481733,1.34E-01,6569.379269,456427332.9,3.17E+13,12533844,72791188,959332306,4916,4875,18911
123565,34426,2336,0.00182521,0.27,7764316,21716782,4253848690,80419136,288647840,9.94E+12,4334267826,0.000492807,2.72E-01,142247.5895,4897015516,1.69E+14,29481098,88183452,4275565472,66099,84849,124761
92341,7302,10440,0.00018467,0.2,124528,15248655,674273982,76232880,964040040,7.04E+12,750506862,3.69E-05,2.00E-01,35605.85484,259993952,1.90E+12,15373183,76357408,689522637,12122,21304,21244
57417,4990,26049,0.00952101,0.27,2728256,35101184,286510830,129984510,1495655433,7.46E+12,416495340,0.002570673,2.80E-01,3844840.59,19185754545,9.58E+13,37829440,132712766,321612014,114566,269536,386953
94340,10152,16472,0.02533638,0.1,24266025,16722661,957739680,167223744,1553968480,1.58E+13,1124963424,0.002533638,1.25E-01,3937193.592,39970389343,4.06E+14,40988686,191489769,974462341,839718,489409,962510
40319,72941,2948,0.00108175,0.05,3181408,10754886,2940908179,215030068,118860412,8.67E+12,3155938247,5.41E-05,5.11E-02,6428.862534,468927662.1,3.42E+13,13936294,218211476,2951663065,14466,15681,53022
52172,6086,36193,0.00056263,0.13,178653,28636974,317518792,220270598,1888261196,1.15E+13,537789390,7.31E-05,1.31E-01,138111.0116,840543616.4,5.12E+12,28815627,220449251,346155766,28872,67004,58368
127748,32756,8112,0.00082487,0.2,3451691,53149283,4184513488,265716672,1036291776,3.39E+13,4450230160,0.000164974,2.01E-01,170961.1995,5600005049,1.83E+14,56600974,269168363,4237662771,94030,195856,214572
8095,56530,2191,0.00491597,0.13,2249845,16101643,457610350,123857230,17736145,1.00E+12,581467580,0.000639076,1.35E-01,11334.74638,640753212.6,3.62E+13,18351488,126107075,473711993,7034,6460,27497
89116,9732,5599,0.00019487,0.13,169010,7084026,867276912,54489468,498960484,4.86E+12,921766380,2.53E-05,1.30E-01,12640.21584,123014580.5,1.20E+12,7253036,54658478,874360938,7298,10127,12887
9247,4600,6508,0.01084252,0.15,461280,4491926,42536200,29936800,60179476,2.77E+11,72473000,0.001626378,1.61E-01,97874.57582,450223048.8,2.07E+12,4953206,30398080,47028126,3773,7696,16290
35390,33639,6233,0.00078778,0.15,937867,31451509,1190484210,209671887,220585870,7.42E+12,1400156097,0.000118167,1.51E-01,26065.9705,876833181.7,2.95E+13,32389376,210609754,1221935719,9831,34773,35095
118270,5395,12366,0.00952101,0.17,6075596,11342507,638066650,66714570,1462526820,7.89E+12,704781220,0.001618572,1.80E-01,2367204.521,12771068393,6.89E+13,17418103,72790166,649409157,214610,244839,493463
74347,55846,7870,0.00952101,0.01,39531852,4395439,4151982562,439508020,585110890,3.27E+13,4591490582,9.52E-05,1.95E-02,55708.46635,3111095012,1.74E+14,43927291,479039872,4156378001,528217,100093,1668677
40304,82417,1274,0.00082185,0.15,2729991,15760247,3321734768,104999258,51347296,4.23E+12,3426734026,0.000123278,1.51E-01,6329.966283,521696831.1,4.30E+13,18490238,107729249,3337495015,5854,9957,20113
39955,23735,3557,0.00296184,0.27,2808903,22801970,948331925,84425395,142119935,3.37E+12,1032757320,0.000799697,2.73E-01,113652.8572,2697550566,6.40E+13,25610873,87234298,971133895,14226,31345,54641
26848,91981,3943,0.00296184,0.17,7314601,61671028,2469505888,362681083,105861664,9.74E+12,2832186971,0.000503513,1.73E-01,53302.70285,4902835911,4.51E+14,68985629,369995684,2531176916,43114,49114,177962
144711,3562,11177,0.00082185,0.27,423709,10752194,515460582,39812474,1617434847,5.76E+12,555273056,0.0002219,2.71E-01,358907.9838,1278430238,4.56E+12,11175903,40236183,526212776,22519,84222,47609
31079,62790,10888,0.00491597,0.01,9593404,6837252,1951450410,683657520,338388152,2.12E+13,2635107930,4.92E-05,1.49E-02,16635.06004,1044515420,6.56E+13,16430656,693250924,1958287662,157632,40408,564415
41058,5686,11014,0.00108175,0.05,252587,3132040,233455788,62625604,452212812,2.57E+12,296081392,5.41E-05,5.11E-02,24459.06047,139074217.8,7.91E+11,3384627,62878191,236587828,8077,10037,20858
96518,11880,20321,0.00047003,0.01,538974,2414244,1146633840,241413480,1961342278,2.33E+13,1388047320,4.70E-06,1.05E-02,9218.897109,109520497.7,1.30E+12,2953218,241952454,1149048084,35467,8353,89347
40745,21940,7324,0.00182521,0.13,1631684,20892047,893945300,160688560,298416380,6.55E+12,1054633860,0.000237277,1.32E-01,70807.43292,1553515078,3.41E+13,22523731,162320244,914837347,23955,40847,67111
60641,8346,26013,0.00860544,0.07,4355582,15198445,506109786,217104498,1577454333,1.32E+13,723214284,0.000602381,7.86E-02,950228.2031,7930604583,6.62E+13,19554027,221460080,521308231,180726,204435,612053
29953,2131,9350,0.00082487,0.3,52656,5978570,63829843,19924850,280060550,5.97E+11,83754693,0.000247461,3.01E-01,69304.06376,147686959.9,3.15E+11,6031226,19977506,69808413,3755,10588,6397
131345,20463,9563,0.00182521,0.27,4905692,52839445,2687712735,195687669,1256052235,2.57E+13,2883400404,0.000492807,2.72E-01,618990.957,12666411952,2.59E+14,57745137,200593361,2740552180,165338,265773,344783
22580,33030,15081,0.00078778,0.07,587567,34871461,745817400,498125430,340528980,1.12E+13,1243942830,5.51E-05,7.08E-02,18778.33439,620248384.9,2.05E+13,35459028,498712997,780688861,27199,37603,65813
143107,69551,6835,4.34E-06,0.13,43197,61802128,9953234957,475381085,978136345,6.80E+13,10428616042,5.64E-07,1.30E-01,551.8645258,38382729.64,2.67E+12,61845325,475424282,10015037085,32032,3926,35055
52745,5375,31446,0.00056263,0.17,159512,28734323,283504375,169022250,1658619270,8.92E+12,452526625,9.56E-05,1.71E-01,158642.1232,852701412.1,4.58E+12,28893835,169181762,312238698,26948,64744,48752
32293,98352,2386,0.00031941,0.13,1014481,30511506,3176081136,234667872,77051098,7.58E+12,3410749008,4.15E-05,1.30E-01,3199.415858,314668948.4,3.10E+13,31525987,235682353,3206592642,6072,10224,10125
2876,2397,49094,0.02533638,0.27,174729,31776040,6893772,117678318,141194344,3.38E+11,124572090,0.006840823,2.95E-01,965885.4594,2315227446,5.55E+12,31950769,117853047,38669812,10239,23192,46333
4962,7533,42916,0.00860544,0.2,321745,64663565,37378746,323286228,212949192,1.60E+12,360664974,0.001721088,2.09E-01,366504.299,2760876884,2.08E+13,64985310,323607973,102042311,49235,49579,76678
24229,6527,12155,0.00952101,0.25,1505806,19835018,158142683,79335685,294503495,1.92E+12,237478368,0.002380253,2.60E-01,700992.6802,4575379224,2.99E+13,21340824,80841491,177977701,28941,48706,97842
85898,58075,6445,0.00370564,0.17,18485798,63637118,4988526350,374293375,553612610,3.22E+13,5362819725,0.000629959,1.74E-01,348753.1355,20253838342,1.18E+15,82122916,392779173,5052163468,301012,270961,702813
11245,56010,8073,0.00019487,0.13,122741,58786002,629832450,452168730,90780885,5.08E+12,1082001180,2.53E-05,1.30E-01,2299.761238,128809626.9,7.22E+12,58908743,452291471,688618452,7276,7970,12019
138185,32186,7066,0.00491597,0.23,21865146,52309993,4447622410,227426276,976415210,3.14E+13,4675048686,0.001130673,2.35E-01,1104006.412,35533550389,1.14E+15,74175139,249291422,4499932403,529157,451442,1124554
135291,86397,9008,0.00163948,5.00E-04,19163682,389151,11688736527,778264176,1218701328,1.05E+14,12467000703,8.20E-07,2.14E-03,999.0182266,86312177.72,7.46E+12,19552833,797427858,11689125678,611157,5372,1273477
113381,42933,4233,0.00860544,0.07,41890630,12722307,4867786473,181735389,479941773,2.06E+13,5049521862,0.000602381,7.86E-02,289107.7092,12412261278,5.33E+14,54612937,223626019,4880508780,497392,185512,1137366
99329,63754,3157,0.00031941,0.15,2022723,30194512,6332621066,201271378,313581653,2.00E+13,6533892444,4.79E-05,1.50E-01,15024.16737,957850766.4,6.11E+13,32217235,203294101,6362815578,14775,47175,46165
126359,94113,1349,0.00031941,0.13,3798479,16514541,11892024567,126958437,170458291,1.60E+13,12018983004,4.15E-05,1.30E-01,7077.990755,666130943.9,6.27E+13,20313020,130756916,11908539108,16151,32680,38709
64180,3726,23916,0.00296184,0.13,708381,11586162,239134680,89111016,1534928880,5.72E+12,328245696,0.000385039,1.33E-01,591007.788,2202095018,8.21E+12,12294543,89819397,250720842,36337,116156,103831
40403,90904,2211,0.00160539,0.3,5896288,60302294,3672794312,200988744,89331033,8.12E+12,3873783056,0.000481617,3.02E-01,43023.34412,3910994074,3.56E+14,66198582,206885032,3733096606,21084,37877,71788
38879,64726,18126,0.00031941,0.005,803800,5866271,2516482154,1173223476,704720754,4.56E+13,3689705630,1.60E-06,5.32E-03,1125.47428,72847448.26,4.72E+12,6670071,1174027276,2522348425,39364,7997,103892
112745,10219,10675,0.00015297,0.1,176246,10908998,1152141155,109087825,1203552875,1.23E+13,1261228980,1.53E-05,1.00E-01,18410.74833,188139437.2,1.92E+12,11085244,109264071,1163050153,15655,16460,27719
96812,59640,213,0.00160539,0.27,9269477,3436330,5773867680,12703320,20620956,1.23E+12,5786571000,0.000433455,2.72E-01,8938.262669,533077985.6,3.19E+13,12705807,21972797,5777304010,5183,7111,12669
141685,11046,7196,0.00041097,0.15,643231,11925181,1565052510,79487016,1019565260,1.13E+13,1644539526,6.16E-05,1.50E-01,62851.61024,694258886.7,7.67E+12,12568412,80130247,1576977691,19300,53239,42764
77620,23824,7966,0.00018467,0.03,341503,5693951,1849218880,189781984,618320920,1.47E+13,2039000864,5.54E-06,3.02E-02,3425.559729,81610534.98,1.94E+12,6035454,190123487,1854912831,12598,7924,25997
23575,8948,27730,0.00370564,0.27,781716,66996953,210949100,248128040,653734750,5.85E+12,459077140,0.001000523,2.74E-01,654076.5225,5852676724,5.24E+13,67778669,248909756,277946053,60451,107823,120840
140966,54271,5749,2.09E-05,0.13,159741,40567960,7650365786,312003979,810413534,4.40E+13,7962369765,2.71E-06,1.30E-01,2199.786497,119384613,6.48E+12,40727701,312163720,7690933746,23356,20061,25551
53554,40303,24466,0.00034241,0.03,739075,29582358,2158386862,986053198,1310252164,5.28E+13,3144440060,1.03E-05,3.03E-02,13459.3033,542450301.1,2.19E+13,30321433,986792273,2187969220,50785,44166,132058
114156,7995,9008,0.00013363,0.3,121974,21609624,912677220,72018960,1028317248,8.22E+12,984696180,4.01E-05,3.00E-01,41224.21016,329587560.2,2.64E+12,21731598,72140934,934286844,16041,26740,21667
116075,22610,9987,0.01084252,0.27,28456074,60971279,2624455750,225806070,1159241025,2.62E+13,2850261820,0.00292748,2.81E-01,3393655.38,76730548132,1.74E+15,89427353,254262144,2685427029,826964,857444,1882301
32906,3914,31697,8.43E-05,0.2,10858,24816783,128794084,124062058,1043021482,4.08E+12,252856142,1.69E-05,2.00E-01,17583.25614,68820864.55,2.69E+11,24827641,124072916,153610867,16498,5068,17386
137955,35382,14524,0.00078778,0.1,3845302,51389721,4881123810,513888168,2003658420,7.09E+13,5395011978,7.88E-05,1.01E-01,157844.203,5584843591,1.98E+14,55235023,517733470,4932513531,199134,276094,437749
130389,74520,2007,1.65E-05,0.2,160423,29926512,9716588280,149561640,261690723,1.95E+13,9866149920,3.30E-06,2.00E-01,864.1027673,64392938.22,4.80E+12,30086935,149722063,9746514792,12886,5409,11857
81359,68007,17325,0.00078778,0.05,4358862,58912212,5532981513,1178221275,1409544675,9.59E+13,6711202788,3.94E-05,5.08E-02,55520.5552,3775786398,2.57E+14,63271074,1182580137,5591893725,171468,205045,483893
98260,16174,8581,0.00491597,0.13,7813044,18043845,1589257240,138789094,843169060,1.36E+13,1728046334,0.000639076,1.35E-01,538849.1945,8715346872,1.41E+14,25856889,146602138,1607301085,172995,165157,420081
15559,17880,12488,0.00015297,0.17,42558,37963300,278194920,223285440,194300792,3.47E+12,501480360,2.60E-05,1.70E-01,5052.772666,90343575.27,1.62E+12,38005858,223327998,316158220,4286,6444,18020
123371,30844,8668,0.00160539,0.13,6109075,34757461,3805255124,267355792,1069379828,3.30E+13,4072610916,0.000208701,1.32E-01,223180.3187,6883773749,2.12E+14,40866536,273464867,3840012585,173106,198590,377116
27298,79766,4489,0.00163948,0.01,3569962,3581339,2177452268,358069574,122540722,9.77E+12,2535521842,1.64E-05,1.16E-02,2009.030629,160252337.2,1.28E+13,7151301,361639536,2181033607,25667,11252,89637
141553,4492,5300,0.00047003,0.23,298938,5477088,635856076,23807600,750230900,3.37E+12,659663676,0.000108107,2.30E-01,81105.13688,364324274.9,1.64E+12,5776026,24106538,641333164,9590,26853,18896
106799,17837,15074,0.00952101,0.2,18137811,53778313,1904973763,268874938,1609888126,2.87E+13,2173848701,0.001904202,2.10E-01,3065552.189,54680254401,9.75E+14,71916124,287012749,1958752076,720904,555376,1730856
97393,27304,10877,0.00041097,0.03,1092894,8909871,2659218472,296985608,1059343661,2.89E+13,2956204080,1.23E-05,3.04E-02,13060.75393,356610825.3,9.74E+12,10002765,298078502,2668128343,32523,29861,90149
14070,53083,14692,0.02533638,0.01,18924549,7799590,746877810,779895436,206716440,1.10E+13,1526773246,0.000253364,3.53E-02,52374.46276,2780193607,1.48E+14,26724139,798819985,754677400,376718,35437,1439452
47748,2131,15014,0.00160539,0.23,163390,7360783,101750988,31994834,716888472,1.53E+12,133745822,0.00036924,2.32E-01,264703.6843,564083551.3,1.20E+12,7524173,32158224,109111771,9706,35097,20323
88232,60784,23716,0.00182521,0.001,9788985,1441623,5363093888,1441553344,2092510112,1.27E+14,6804647232,1.83E-06,2.83E-03,3819.270382,232150530.9,1.41E+13,11230608,1451342329,5364535511,526233,17520,1410079
58590,32693,7041,0.00108175,0.13,2072146,29926629,1915482870,230191413,412532190,1.35E+13,2145674283,0.000140628,1.31E-01,58013.37055,1896631123,6.20E+13,31998775,232263559,1945409499,34854,57292,82174
29902,28984,38266,0.00108175,0.03,937572,33274410,866679568,1109101744,1144229932,3.32E+13,1975781312,3.25E-05,3.11E-02,37133.12187,1076266404,3.12E+13,34211982,1110039316,899953978,70277,76994,217923
84201,22342,9230,0.01084252,0.2,20397716,41245006,1881218742,206216660,777175230,1.74E+13,2087435402,0.002168504,2.11E-01,1685307.595,37653142287,8.41E+14,61642722,226614376,1922463748,391455,385863,1042581
2931,62754,8260,0.02533638,0.07,4661285,36287038,183931974,518348040,24210060,1.52E+12,702280014,0.001773547,9.53E-02,42937.6696,2694510518,1.69E+14,40948323,523009325,220219012,51134,24041,200444
49865,41784,1999,0.00082282,0.27,1714412,22559740,2083559160,83526216,99680135,4.17E+12,2167085376,0.000222161,2.71E-01,22145.07834,925309953.5,3.87E+13,24274152,85240628,2106118900,5841,16648,24767
77232,67089,4255,0.00860544,0.13,44588813,37115150,5181417648,285463695,328622160,2.20E+13,5466881343,0.001118707,1.39E-01,367631.9765,24664061669,1.65E+15,81703963,330052508,5218532798,341898,233931,1014439
39010,9078,33934,0.00370564,0.15,1312402,46212117,354132780,308052852,1323765340,1.20E+13,662185632,0.000555846,1.54E-01,735809.6692,6679680177,6.06E+13,47524519,309365254,400344897,79431,189461,241991
110072,20278,11682,0.00860544,0.2,19208585,47382558,2232040016,236887596,1285861104,2.61E+13,2468927612,0.001721088,2.09E-01,2213080.116,44876838587,9.10E+14,66591143,256096181,2279422574,621006,444126,1419988
59585,74754,16187,0.00015297,0.005,681372,6050546,4454217090,1210042998,964502395,7.21E+13,5664260088,7.65E-07,5.15E-03,737.6996568,55146000.15,4.12E+12,6731918,1210724370,4460267636,38369,4312,88303
59470,41601,16892,0.00041097,0.01,1016753,7027616,2474011470,702724092,1004567240,4.18E+13,3176735562,4.11E-06,1.04E-02,4128.469986,171748479.9,7.15E+12,8044369,703740845,2481039086,38478,14283,111859
73733,72452,704,0.00047003,0.3,2511000,15312633,5342103316,51006208,51908032,3.76E+12,5393109524,0.000141009,3.00E-01,7319.499684,530312391.1,3.85E+13,17823633,53517208,5357415949,3234,9113,11516
43133,62942,2652,0.00047003,0.13,1276096,21701382,2714877286,166922184,114388716,7.20E+12,2881799470,6.11E-05,1.30E-01,6989.596664,439939193.2,2.77E+13,22977478,168198280,2736578668,6466,19887,20810
83377,64028,11307,0.00041097,0.03,2194003,21720017,5338462556,723964596,942743739,6.04E+13,6062427152,1.23E-05,3.04E-02,11623.18183,744209086.4,4.77E+13,23914020,726158599,5360182573,59569,66023,170219
36458,44661,39969,0.00952101,0.005,15503072,8925613,1628250738,1785055509,1457189802,6.51E+13,3413306247,4.76E-05,1.45E-02,69369.59338,3098115410,1.38E+14,24428685,1800558581,1637176351,934983,138056,3176011
141588,21428,3550,0.00018467,0.1,560287,7608172,3033947664,76069400,502637400,1.08E+13,3110017064,1.85E-05,1.00E-01,9282.204866,198899085.9,4.26E+12,8168459,76629687,3041555836,9834,17138,21584
63548,45979,19191,0.00056263,0.05,1643964,44120881,2921873492,882382989,1219549668,5.61E+13,3804256481,2.81E-05,5.06E-02,34307.76149,1577436565,7.25E+13,45764845,884026953,2965994373,72080,117006,202891
26703,74691,22749,8.43E-05,0.01,168118,16992017,1994473773,1699145559,607466547,4.54E+13,3693619332,8.43E-07,1.01E-02,512.0335525,38244298.07,2.86E+12,17160135,1699313677,2011465790,38779,3553,56702
63747,46730,22053,0.00082185,0.005,2448262,5152867,2978897310,1030536690,1405812591,6.57E+13,4009434000,4.11E-06,5.82E-03,5776.83539,269951517.8,1.26E+13,7601129,1032984952,2984050177,94304,19598,311427
33185,86416,16935,0.00952101,0.001,27304208,1463532,2867714960,1463454960,561987975,4.86E+13,4331169920,9.52E-06,1.05E-02,5350.69313,462385497.5,4.00E+13,28767740,1490759168,2869178492,680854,24813,2369563
69175,16274,14814,0.00047003,0.05,529169,12055484,1125753950,241083036,1024758450,1.67E+13,1366836986,2.35E-05,5.05E-02,24083.36071,391932612.2,6.38E+12,12584653,241612205,1137809434,22310,29210,59227
109228,25348,5275,0.00163948,0.13,4539417,17384897,2768711344,133710700,576177700,1.46E+13,2902422044,0.000213132,1.32E-01,122802.136,3112788544,7.89E+13,21924314,138250117,2786096241,71297,93938,160415
142562,37467,3085,0.00041097,0.15,2195162,17338286,5341370454,115585695,439803770,1.65E+13,5456956149,6.16E-05,1.50E-01,27111.9233,1015802430,3.81E+13,19533448,117780857,5358708740,26669,58969,54679
147751,75258,10129,0.00031941,0.005,3551712,3811632,11119444758,762288282,1496569879,1.13E+14,11881733040,1.60E-06,5.32E-03,2390.096925,179873914.4,1.35E+13,7363344,765839994,11123256390,128220,14374,294244
32314,2144,8760,0.00296184,0.15,205221,2817707,69281216,18781440,283070640,6.07E+11,88062656,0.000444276,1.53E-01,125761.4917,269632638.1,5.78E+11,3022928,18986661,72098923,4814,14211,12748
139897,49460,2960,0.00182521,0.05,12629356,7321594,6919305620,146401600,414095120,2.05E+13,7065707220,9.13E-05,5.18E-02,37790.5277,1869119500,9.25E+13,19950950,159030956,6926627214,142512,70782,275669
83826,30839,11021,0.02533638,0.17,65497623,57781073,2585110014,339876619,923846346,2.85E+13,2924986633,0.004307185,1.95E-01,3979176.754,1.23E+11,3.78E+15,123278696,405374242,2642891087,1372056,1055493,3917770
113894,7882,5236,0.02533638,0.13,22745018,5365824,897712508,41270152,596348984,4.70E+12,938982660,0.003293729,1.55E-01,1964212.181,15481920413,1.22E+14,28110842,64015170,903078332,285441,162839,301817
142464,94820,844,0.00160539,0.3,21686349,24010189,13508436480,80028080,120239616,1.14E+13,13588464560,0.000481617,3.02E-01,57909.44314,5490973398,5.21E+14,45696538,101714429,13532446669,69522,70138,138342
119561,1522,6054,0.01084252,0.17,1973556,1566962,181971842,9214188,723822294,1.10E+12,191186030,0.001843228,1.81E-01,1334169.809,2030606449,3.09E+12,3540518,11187744,183538804,27729,71045,80668
53559,66856,3035,0.01084252,5.00E-04,38825420,101458,3580740504,202907960,162551565,1.09E+13,3783648464,5.42E-06,1.13E-02,881.2342973,58915800.18,3.94E+12,38926878,241733380,3580841962,186126,3125,604805
81724,58758,3114,2.09E-05,0.25,100265,45750072,4801938792,182972412,254488536,1.50E+13,4984911204,5.22E-06,2.50E-01,1328.430158,78055899.22,4.59E+12,45850337,183072677,4847688864,3911,6319,15494
59148,13274,9381,0.01084252,0.005,8513016,622645,785130552,124523394,554867388,7.37E+12,909653946,5.42E-05,1.58E-02,30080.80376,399292589.1,5.30E+12,9135661,133036410,785753197,132249,26554,424570
100118,11748,9226,0.00182521,0.25,2146861,27099502,1176186264,108387048,923688668,1.09E+13,1284573312,0.000456303,2.52E-01,421481.4484,4951564056,5.82E+13,29246363,110533909,1203285766,55592,152398,135648
112858,36186,11984,0.00031941,0.13,1304471,56380562,4083879588,433653024,1352490272,4.89E+13,4517532612,4.15E-05,1.30E-01,56159.85931,2032200669,7.35E+13,57685033,434957495,4140260150,60434,154425,121227
128860,43932,14497,0.00034241,0.005,1938426,3184489,5661077520,636882204,1868083420,8.21E+13,6297959724,1.71E-06,5.34E-03,3198.252219,140505616.5,6.17E+12,5122915,638820630,5664262009,83227,11701,227207
4326,40343,6596,0.00370564,0.13,646812,34596220,174523818,266102428,28534296,1.15E+12,440626246,0.000481733,1.34E-01,13745.91772,554551558.7,2.24E+13,35243032,266749240,209120038,7769,6827,25705
33442,7980,13858,0.00041097,0.23,109680,25436471,266867160,110586840,463439236,3.70E+12,377454000,9.45E-05,2.30E-01,43805.71325,349569591.7,2.79E+12,25546151,110696520,292303631,14760,25018,7927
127953,32276,13165,0.00370564,0.13,15304082,55241997,4129811028,424913540,1684501245,5.44E+13,4554724568,0.000481733,1.34E-01,811480.1752,26191334133,8.45E+14,70546079,440217622,4185053025,679207,399589,1404512
7814,59894,5017,0.00047003,0.07,219995,21037113,468011716,300488198,39202838,2.35E+12,768499914,3.29E-05,7.05E-02,1289.855696,77254617.07,4.63E+12,21257108,300708193,489048829,5512,3822,8869
84252,55455,8994,0.00013363,0.07,624351,34917097,4672194660,498762270,757762488,4.20E+13,5170956930,9.35E-06,7.01E-02,7088.186089,393075359.6,2.18E+13,35541448,499386621,4707111757,30762,36571,61989
104484,3891,5277,0.00491597,0.13,1998911,2669932,406547244,20532807,551362068,2.15E+12,427080051,0.000639076,1.35E-01,352362.3201,1371041788,5.34E+12,4668843,22531718,409217176,25872,58553,70001
50720,6003,36444,0.00108175,0.17,329375,37192673,304472160,218773332,1848439680,1.11E+13,523245492,0.000183898,1.71E-01,339923.4361,2040560387,1.23E+13,37522048,219102707,341664833,43212,134107,85870
47679,20880,10732,0.01084252,0.05,10794459,11205034,995537520,224084160,511691028,1.07E+13,1219621680,0.000542126,6.08E-02,277401.0102,5792133094,1.21E+14,21999493,234878619,1006742554,187032,83706,610004
14048,771,13751,0.00860544,0.15,93233,1590754,10831008,10602021,193174048,1.49E+11,21433029,0.001290816,1.59E-01,249352.1519,192250509.1,1.48E+11,1683987,10695254,12421762,3281,10364,8331
23231,3666,17528,0.01084252,0.15,923543,9640168,85164846,64257648,407192968,1.49E+12,149422494,0.001626378,1.61E-01,662249.6849,2427807345,8.90E+12,10563711,65181191,94805014,23470,51971,87796
131503,46495,3807,0.00019487,0.27,1191490,47802468,6114231985,177006465,500631921,2.33E+13,6291238450,5.26E-05,2.70E-01,26340.69846,1224710775,5.70E+13,48993958,178197955,6162034453,30850,69208,38575
42661,98275,810,0.00082282,0.3,3449722,23882852,4192509775,79602750,34555410,3.40E+12,4272112525,0.000246846,3.01E-01,8529.864737,838272457,8.24E+13,27332574,83052472,4216392627,4908,11151,16124
124491,2989,8506,0.00019487,0.25,72515,6356963,372103599,25424434,1058920446,3.17E+12,397528033,4.87E-05,2.50E-01,51587.95683,154196403,4.61E+11,6429478,25496949,378460562,10439,12515,16672
41526,6876,37572,2.48E-05,0.17,7090,43921099,285532776,258345072,1560214872,1.07E+13,543877848,4.22E-06,1.70E-01,6585.822996,45284118.92,3.11E+11,43928189,258352162,329453875,21326,3534,30719
73264,36226,14057,0.00860544,0.05,22839600,25462876,2654061664,509228882,1029872048,3.73E+13,3163290546,0.000430272,5.86E-02,443125.1058,16052650084,5.82E+14,48302476,532068482,2679524540,536907,254696,1729985
109787,84007,12567,0.00082185,0.005,7579868,5278713,9222876509,1055715969,1379693229,1.16E+14,10278592478,4.11E-06,5.82E-03,5669.504401,476278056.2,4.00E+13,12858581,1063295837,9228155222,287485,39415,673062
92892,29227,5911,0.00015297,0.23,415318,39742536,2714954484,172760797,549084612,1.60E+13,2887715281,3.52E-05,2.30E-01,19318.49881,564621764.8,1.65E+13,40157854,173176115,2754697020,22950,49584,23075
12871,12566,48371,0.00078778,0.1,127428,60786423,161736986,607829986,622583141,7.82E+12,769566972,7.88E-05,1.01E-01,49045.85468,616310209.9,7.75E+12,60913851,607957414,222523409,39145,47300,67548
136773,60533,4472,2.09E-05,0.13,172872,35191674,8279280009,270703576,611648856,3.70E+13,8549983585,2.71E-06,1.30E-01,1660.259655,100500497.7,6.08E+12,35364546,270876448,8314471683,21816,8839,20734
12971,33483,15175,0.00182521,0.13,792721,66058274,434307993,508104525,196834925,6.59E+12,942412518,0.000237277,1.32E-01,46704.45955,1563805419,5.24E+13,66850995,508897246,500366267,19275,27075,69629
77879,63025,11611,0.00013363,0.05,655911,36592561,4908323975,731783275,904253069,5.70E+13,5640107250,6.68E-06,5.01E-02,6041.766881,380782357.6,2.40E+13,37248472,732439186,4944916536,37782,29292,75373
41815,28148,4767,0.02533638,0.3,29821998,40258047,1177008620,134181516,199332105,5.61E+12,1311190136,0.007600914,3.25E-01,1515106.188,42647208967,1.20E+15,70080045,164003514,1217266667,207516,247776,718715
115202,59641,6193,0.00160539,0.03,11030405,11082500,6870762482,369356713,713445986,4.26E+13,7240119195,4.82E-05,3.16E-02,34360.77154,2049310776,1.22E+14,22112905,380387118,6881844982,212349,97268,466523
50522,8252,10560,0.00296184,0.05,1234850,4357242,416907544,87141120,533512320,4.40E+12,504048664,0.000148092,5.30E-02,79008.90649,651981496.4,5.38E+12,5592092,88375970,421264786,22221,36522,73017
35557,50527,33258,0.02533638,0.005,45519939,8402353,1796588539,1680426966,1182554706,5.98E+13,3477015505,0.000126682,3.03E-02,149808.277,7569362812,3.82E+14,53922292,1725946905,1804990892,2244357,174933,7688832
73339,16870,16588,0.00182521,0.23,2258237,64363645,1237228930,279839560,1216547332,2.05E+13,1517068490,0.000419798,2.32E-01,510704.5018,8615584946,1.45E+14,66621882,282097797,1301592575,84968,226839,212262
9299,41487,5783,0.00078778,0.25,303943,59988259,385787613,239919321,53776117,2.23E+12,625706934,0.000196945,2.51E-01,10590.93736,439386218.4,1.82E+13,60292202,240223264,445775872,5219,7832,12612
86521,33964,16898,0.00370564,0.1,10889559,57393292,2938599244,573923672,1462031858,4.97E+13,3512522916,0.000370564,1.04E-01,541776.3734,18400892747,6.25E+14,68282851,584813231,2995992536,421135,332223,1059022
7293,88117,3594,0.00015297,0.15,98310,47505746,642637281,316692498,26211042,2.31E+12,959329779,2.29E-05,1.50E-01,601.4254642,52995807.63,4.67E+12,47604056,316790808,690143027,3821,3486,5971
26691,23258,14148,0.00041097,0.03,255133,9872247,620779278,329054184,377624268,8.78E+12,949833462,1.23E-05,3.04E-02,4655.767363,108283837.3,2.52E+12,10127380,329309317,630651525,14114,7660,28946
98066,41967,4088,0.00082282,0.23,3386379,39465343,4115535822,171561096,400893808,1.68E+13,4287096918,0.000189249,2.31E-01,75868.59191,3183977197,1.34E+14,42851722,174947475,4155001165,48364,79696,90221
116613,13871,7347,0.00082185,0.07,1329414,7134207,1617538923,101910237,856755711,1.19E+13,1719449160,5.75E-05,7.08E-02,49288.72768,683683941.6,9.48E+12,8463621,103239651,1624673130,25648,48013,70933
12390,12503,17078,0.00056263,0.15,87166,32030299,154912170,213526234,211596420,2.65E+12,368438404,8.44E-05,1.51E-01,17857.57407,223273248.6,2.79E+12,32117465,213613400,186942469,17567,12458,18269
48349,27792,27748,0.00082185,0.07,1104360,53983736,1343715408,771172416,1341588052,3.73E+13,2114887824,5.75E-05,7.08E-02,77180.88984,2145011290,5.96E+13,55088096,772276776,1397699144,71581,126592,199104
88274,73012,4168,0.00015297,0.2,985914,60871976,6445061288,304314016,367926032,2.69E+13,6749375304,3.06E-05,2.00E-01,11256.32902,821847094.6,6.00E+13,61857890,305299930,6505933264,10803,41958,32050
146067,6562,7358,2.48E-05,0.25,23801,12072634,958491654,48283196,1074760986,7.05E+12,1006774850,6.21E-06,2.50E-01,6671.578821,43778900.22,2.87E+11,12096435,48306997,970564288,10154,3023,11790
105587,27508,4739,0.00078778,0.07,2288163,9126957,2904487196,130360412,500376793,1.38E+13,3034847608,5.51E-05,7.08E-02,27593.0781,759030392.4,2.09E+13,11415120,132648575,2913614153,28367,46523,74781
81464,7120,25173,0.00491597,0.05,2851458,8961824,580023680,179231760,2050693272,1.46E+13,759255440,0.000245799,5.49E-02,504057.3302,3588888191,2.56E+13,11813282,182083218,588985504,128913,175920,404195
125857,42282,11878,0.00108175,0.13,5756540,65294101,5321485674,502225596,1494929446,6.32E+13,5823711270,0.000140628,1.31E-01,210228.1907,8888868358,3.76E+14,71050641,507982136,5386779775,242265,279746,490901
128261,9592,15190,0.00034241,0.27,421271,39342141,1230279512,145702480,1948284590,1.87E+13,1375981992,9.25E-05,2.70E-01,180120.2741,1727713670,1.66E+13,39763412,146123751,1269621653,40058,128722,66028
25669,4966,8747,0.00082185,0.2,104775,8688468,127472254,43437602,224526743,1.12E+12,170909856,0.00016437,2.01E-01,36905.46075,183272518.1,9.10E+11,8793243,43542377,136160722,4782,12479,9104
102238,46444,5011,0.00108175,0.2,5136538,46554403,4748341672,232730884,512314618,2.38E+13,4981072556,0.00021635,2.01E-01,110839.2676,5147818945,2.39E+14,51690941,237867422,4794896075,82738,110177,169766
40058,38153,33365,0.00108175,0.005,1653316,6365225,1528332874,1272974845,1336535170,5.10E+13,2801307719,5.41E-06,6.08E-03,7228.984601,275807449.5,1.05E+13,8018541,1274628161,1534698099,88492,19656,315380
22717,23456,9074,0.00078778,0.27,419776,57471245,532849952,212839744,206134058,4.84E+12,745689696,0.000212701,2.71E-01,43844.83782,1028424516,2.41E+13,57891021,213259520,590321197,30435,34994,23537
130451,3348,5445,0.00056263,0.27,245799,4923828,436749948,18229860,710305695,2.38E+12,454979808,0.00015191,2.71E-01,107902.6092,361257935.5,1.21E+12,5169627,18475659,441673776,8656,25765,15951
51667,59315,34324,0.00296184,0.01,9077075,20359700,3064628105,2035928060,1773418108,1.05E+14,5100556165,2.96E-05,1.30E-02,52525.80689,3115568236,1.85E+14,29436775,2045005135,3084987805,506844,167222,1645889
35930,18510,43427,0.00108175,0.05,719456,40193270,665064300,803833770,1560332110,2.89E+13,1468898070,5.41E-05,5.11E-02,84394.463,1562141510,2.89E+13,40912726,804553226,705257570,67415,113626,195502
102296,49130,19240,0.00082487,0.001,4145695,945278,5025802480,945261200,1968175040,9.67E+13,5971063680,8.25E-07,1.82E-03,1623.488545,79761992.23,3.92E+12,5090973,949406895,5026747758,204505,5284,532528
10672,69703,3104,0.02533638,0.27,18847451,58433424,743870416,216358112,33125888,2.31E+12,960228528,0.006840823,2.95E-01,226608.3233,15795279957,1.10E+15,77280875,235205563,802303840,78802,98574,296070
45392,20350,19204,0.00013363,0.13,123441,50807587,923727200,390801400,871707968,1.77E+13,1314528600,1.74E-05,1.30E-01,15143.22365,308164601.3,6.27E+12,50931028,390924841,974534787,31389,20828,28563
80022,60627,9037,0.00019487,0.1,945424,54794058,4851493794,547886199,723158814,4.38E+13,5399379993,1.95E-05,1.00E-01,14092.19581,854367555.3,5.18E+13,55739482,548831623,4906287852,43397,76519,83184
44171,76085,461,0.00296184,0.3,9954267,10531483,3360750535,35075185,20362831,1.55E+12,3395825720,0.000888552,3.03E-01,18093.43421,1376638942,1.05E+14,20485750,45029452,3371282018,7240,11527,24159
90671,14282,15507,1.65E-05,0.2,21380,44297385,1294963222,221470974,1406035197,2.01E+13,1516434196,3.30E-06,2.00E-01,4642.72822,66307444.45,9.47E+11,44318765,221492354,1339260607,19951,5388,23697
78709,24244,14016,8.43E-05,0.05,160849,16991946,1908220996,339803904,1103185344,2.67E+13,2248024900,4.21E-06,5.01E-02,4649.374632,112719438.6,2.73E+12,17152795,339964753,1925212942,21235,13283,35467
63788,71216,18054,0.00182521,0.03,8291531,38574127,4542726208,1285733664,1151628552,8.20E+13,5828459872,5.48E-05,3.18E-02,63058.91848,4490803939,3.20E+14,46865658,1294025195,4581300335,267031,166723,819427
97165,68569,4654,0.00296184,0.15,19733663,47874562,6662506885,319120126,452205910,3.10E+13,6981627011,0.000444276,1.53E-01,200904.2329,13775802344,9.45E+14,67608225,338853789,6710381447,224517,190954,555238
89490,74614,2024,0.00952101,0.001,63574769,151024,6677206860,151018736,181127760,1.35E+13,6828225596,9.52E-06,1.05E-02,1724.519214,128673276.7,9.60E+12,63725793,214593505,6677357884,291891,20373,740885
58210,37778,9183,0.00108175,0.03,2378882,10408478,2199057380,346915374,534542430,2.02E+13,2545972754,3.25E-05,3.11E-02,17347.23821,655343965.1,2.48E+13,12787360,349294256,2209465858,40075,43297,126355
114059,34686,11559,0.00015297,0.05,605203,20048095,3956250474,400935474,1318407981,4.57E+13,4357185948,7.65E-06,5.02E-02,10083.84344,349768193.7,1.21E+13,20653298,401540677,3976298569,33545,28881,72446
31683,32508,6174,0.00015297,0.17,157556,34122834,1029950964,200704392,195610842,6.36E+12,1230655356,2.60E-05,1.70E-01,5086.840385,165363007.2,5.38E+12,34280390,200861948,1064073798,4775,9600,9435
72822,57831,14154,0.00031941,0.07,1345182,57301813,4211369082,818539974,1030722588,5.96E+13,5029909056,2.24E-05,7.03E-02,23045.61713,1332751084,7.71E+13,58646995,819885156,4268670895,62342,104483,143247
2739,78424,15866,0.00018467,0.05,39677,62217421,214803336,1244275184,43456974,3.41E+12,1459078520,9.23E-06,5.02E-02,401.2599694,31468411.84,2.47E+12,62257098,1244314861,277020757,11033,3192,16014
6103,20251,12405,0.00296184,0.27,366104,67833284,123591853,251213655,75707715,1.53E+12,374805508,0.000799697,2.73E-01,60543.21742,1226060696,2.48E+13,68199388,251579759,191425137,7851,14390,26794
65858,3776,26687,0.00078778,0.27,195927,27211303,248679808,100770112,1757552446,6.64E+12,349449920,0.000212701,2.71E-01,373832.4598,1411591368,5.33E+12,27407230,100966039,275891111,29747,93396,47443
38914,15694,4996,0.01084252,0.3,6622177,23528295,610716316,78407224,194414344,3.05E+12,689123540,0.003252756,3.11E-01,632382.4239,9924609761,1.56E+14,30150472,85029401,634244611,50011,73489,176390
44704,5811,14677,0.00108175,0.17,281051,14501473,259774944,85288047,656120608,3.81E+12,345062991,0.000183898,1.71E-01,120658.9395,701149097.5,4.08E+12,14782524,85569098,274276417,12487,43810,30158
66823,75696,25692,0.00163948,0.03,8293048,58345779,5058233808,1944781632,1716816516,1.30E+14,7003015440,4.92E-05,3.16E-02,84440.59025,6391814920,4.84E+14,66638827,1953074680,5116579587,387678,258484,1175183
74994,27738,25355,0.00082185,0.05,1709621,35165355,2080183572,703296990,1901472870,5.27E+13,2783480562,4.11E-05,5.08E-02,78136.27391,2167343966,6.01E+13,36874976,705006611,2115348927,92243,148103,269087
135355,38202,11339,0.00056263,0.07,2909288,30324708,5170831710,433172478,1534790345,5.86E+13,5604004188,3.94E-05,7.06E-02,60446.33643,2309170944,8.82E+13,33233996,436081766,5201156418,117395,155019,262164
66726,22607,1330,0.00163948,0.13,2473191,3910963,1508474682,30067310,88745580,2.01E+12,1538541992,0.000213132,1.32E-01,18914.55845,427601423,9.67E+12,6384154,32540501,1512385645,7157,13739,18964
36799,5092,43610,0.00047003,0.03,88077,6662024,187380508,222062120,1604804390,8.17E+12,409442628,1.41E-05,3.05E-02,22629.18622,115227816.2,5.87E+11,6750101,222150197,194042532,21095,9040,39511
129648,25185,11868,0.00082185,0.17,2683583,50813846,3265184880,298895580,1538662464,3.88E+13,3564080460,0.000139715,1.71E-01,214973.4568,5414106510,1.36E+14,53497429,301579163,3315998726,114832,232249,243811
142307,8033,2625,0.00163948,0.27,1874270,5695502,1143152131,21086625,373555875,3.00E+12,1164238756,0.00044266,2.72E-01,165358.0942,1328321571,1.07E+13,7569772,22960895,1148847633,15165,49099,36543
57597,63238,755,0.00078778,0.3,2869437,14330699,3642319086,47744690,43485735,2.75E+12,3690063776,0.000236334,3.01E-01,10277.1577,649906898.3,4.11E+13,17200136,50614127,3656649785,3797,9590,12643
124800,17746,12206,0.00082185,0.15,1820176,32491617,2214700800,216607676,1523308800,2.70E+13,2431308476,0.000123278,1.51E-01,187789.7006,3332516027,5.91E+13,34311793,218427852,2247192417,71700,180211,166687
136659,27940,12162,0.00296184,0.15,11309213,50973075,3818252460,339806280,1662046758,4.64E+13,4158058740,0.000444276,1.53E-01,738407.4855,20631105144,5.76E+14,62282288,351115493,3869225535,501174,394792,965549
78162,24539,11588,0.00082282,0.13,1578228,36970027,1918017318,284357932,905741256,2.22E+13,2202375250,0.000106967,1.31E-01,96884.06263,2377438013,5.83E+13,38548255,285936160,1954987345,41478,119068,112382
12643,99596,2325,0.00041097,0.13,517516,30104139,1259192228,231560700,29394975,2.93E+12,1490752928,5.34E-05,1.30E-01,1570.458874,156411422,1.56E+13,30621655,232078216,1289296367,4775,4143,10349
36139,72013,4378,0.00041097,0.03,1069560,9458446,2602477807,315272914,158216542,1.14E+13,2917750721,1.23E-05,3.04E-02,1950.667568,140473423.6,1.01E+13,10528006,316342474,2611936253,10387,9574,30334
63775,44774,6798,8.43E-05,0.17,240692,51750197,2855461850,304373652,433542450,1.94E+13,3159835502,1.43E-05,1.70E-01,6212.359829,278152199,1.25E+13,51990889,304614344,2907212047,8215,19747,12405
148354,99024,4604,0.00370564,0.13,54438984,59269117,14690606496,455906496,683021816,6.76E+13,15146512992,0.000481733,1.34E-01,329034.2851,32582291047,3.23E+15,113708101,510345480,14749875613,943274,466170,1866179
54699,76215,798,0.00491597,0.17,20494607,10346173,4168884285,60819570,43649802,3.33E+12,4229703855,0.000835715,1.75E-01,36478.78991,2780230973,2.12E+14,30840780,81314177,4179230458,25478,24194,88026
113043,41077,3683,0.00047003,0.03,2182611,4539368,4643467311,151286591,416337369,1.71E+13,4794753902,1.41E-05,3.05E-02,5870.731607,241152042.2,9.91E+12,6721979,153469202,4648006679,21629,18262,60673
66980,36237,9185,0.00082487,0.13,2002126,43272073,2427154260,332836845,615211300,2.23E+13,2759991105,0.000107233,1.31E-01,65971.01485,2390591665,8.66E+13,45274199,334838971,2470426333,48177,90976,109094
141073,28126,2326,0.00160539,0.005,6369983,327166,3967819198,65421076,328135798,9.23E+12,4033240274,8.03E-06,6.61E-03,2633.929644,74081905.16,2.08E+12,6697149,71791059,3968146364,52735,5104,114109
149793,78568,2030,0.00082487,0.17,9707925,27118251,11768936424,159493040,304079790,2.39E+13,11928429464,0.000140228,1.71E-01,42640.47038,3350176477,2.63E+14,36826176,169200965,11796054675,86853,76822,151349
23140,8628,35039,0.00370564,0.2,739906,60468002,199651920,302316492,810802460,7.00E+12,501968412,0.000741128,2.04E-01,600908.4056,5184637723,4.47E+13,61207908,303056398,260119922,46308,135775,145361
37092,15365,48284,1.65E-05,0.07,9409,51934231,569918580,741883660,1790950128,2.75E+13,1311802240,1.16E-06,7.00E-02,2069.801063,31802493.33,4.89E+11,51943640,741893069,621852811,38043,3064,45723
53386,9774,22227,1.65E-05,0.27,8615,58664254,521794764,217246698,1186610622,1.16E+13,739041462,4.46E-06,2.70E-01,5289.55417,51700102.45,5.05E+11,58672869,217255313,580459018,20011,4190,32430
105119,8191,8952,0.00108175,0.15,931427,10999742,861029729,73325832,941025288,7.71E+12,934355561,0.000162263,1.51E-01,152693.1158,1250709311,1.02E+13,11931169,74257259,872029471,23168,78388,61382
100983,44691,9699,0.00082282,0.07,3713475,30343085,4513031253,433458009,979434117,4.38E+13,4946489262,5.76E-05,7.08E-02,56412.85861,2521147064,1.13E+14,34056560,437171484,4543374338,97746,135842,250694
143129,14578,12341,0.00015297,0.23,319183,41380938,2086534562,179907098,1766354989,2.57E+13,2266441660,3.52E-05,2.30E-01,62145.84421,905962116.9,1.32E+13,41700121,180226281,2127915500,37084,81732,53149
74042,43256,5628,0.01084252,0.27,34726753,65739047,3202760752,243444768,416708376,1.80E+13,3446205520,0.00292748,2.81E-01,1219905.603,52768236774,2.28E+15,100465800,278171521,3268499799,347495,468606,1085329
132476,27494,4938,0.00019487,0.2,709797,27158635,3642295144,135765372,654166488,1.80E+13,3778060516,3.90E-05,2.00E-01,25495.4847,700972856.4,1.93E+13,27868432,136475169,3669453779,21340,51941,31707
148584,39440,1374,0.00018467,0.15,1082204,8132810,5860152960,54190560,204154416,8.05E+12,5914343520,2.77E-05,1.50E-01,5655.1794,223040275.6,8.80E+12,9215014,55272764,5868285770,6642,18269,12597
55773,16286,14336,0.00041097,0.1,373319,23350367,908319078,233476096,799561728,1.30E+13,1141795174,4.11E-05,1.00E-01,32859.58834,535151255.6,8.72E+12,23723686,233849415,931669445,19313,39790,46452
99970,39586,20225,0.00013363,0.005,528846,4003415,3957412420,800626850,2021893250,8.00E+13,4758039270,6.68E-07,5.13E-03,1350.927975,53477834.82,2.12E+12,4532261,801155696,3961415835,42402,3823,103302
126823,88859,2657,0.00163948,0.15,18476023,35422494,11269364957,236098363,336968711,2.99E+13,11505463320,0.000245922,1.52E-01,82868.01935,7363569331,6.54E+14,53898517,254574386,11304787451,182056,114249,366042
61976,26432,5920,0.00047003,0.2,769992,31299575,1638149632,156477440,366897920,9.70E+12,1794627072,9.40E-05,2.00E-01,34490.60587,911655694.3,2.41E+13,32069567,157247432,1669449207,20813,46613,29937
138522,71083,4335,0.00056263,0.2,5540010,61642556,9846559326,308144805,600492870,4.27E+13,10154704131,0.000112526,2.01E-01,67571.06069,4803153707,3.42E+14,67182566,313684815,9908201882,79770,141877,183202
112945,18830,13819,0.00163948,0.001,3486790,260221,2126754350,260211770,1560786955,2.94E+13,2386966120,1.64E-06,2.64E-03,2558.878997,48183691.51,9.07E+11,3747011,263698560,2127014571,121657,3001,332038
67946,1906,17897,0.02533638,0.2,3281547,6823200,129505076,34111682,1216029562,2.32E+12,163616758,0.005067276,2.25E-01,6161957.415,11744690833,2.24E+13,10104747,37393229,136328276,87499,181142,314589
84008,18577,1006,0.02533638,0.2,39540932,3740510,1560616616,18688462,84512048,1.57E+12,1579305078,0.005067276,2.25E-01,428245.8725,7955523574,1.48E+14,43281442,58229394,1564357126,73877,68760,85715
20418,11968,27891,0.00082185,0.2,200845,66765881,244362624,333799488,569478438,6.82E+12,578162112,0.00016437,2.01E-01,93605.17085,1120266685,1.34E+13,66966726,334000333,311128505,37855,63946,38350
30333,14254,14880,0.00041097,0.25,177699,53028812,432366582,212099520,451355040,6.43E+12,644466102,0.000102743,2.50E-01,46373.3452,661005662.4,9.42E+12,53206511,212277219,485395394,7381,43953,20434
49759,2614,21492,0.00082487,0.17,107315,9552833,130070026,56180088,1069420428,2.80E+12,186250114,0.000140228,1.71E-01,149962.5808,392002186.3,1.03E+12,9660148,56287403,139622859,13002,26405,25545
86839,13389,21867,0.01084252,0.03,12607482,8784267,1162687371,292777263,1898908413,2.54E+13,1455464634,0.000325276,4.08E-02,617668.5734,8269964529,1.11E+14,21391749,305384745,1171471638,588059,253348,1588297
23962,71633,21505,0.00056263,0.03,965770,46214520,1716469946,1540467665,515302810,3.69E+13,3256937611,1.69E-05,3.06E-02,8697.7446,623045538.9,4.46E+13,47180290,1541433435,1762684466,46116,47498,154104
27872,33660,4176,0.00860544,0.3,8073829,42171004,938171520,140564160,116393472,3.92E+12,1078735680,0.002581632,3.09E-01,300485.1119,10114328867,3.40E+14,50244833,148637989,980342524,47880,71722,177573
119534,14986,296,0.00952101,0.15,17056374,665588,1791336524,4435856,35382064,5.30E+11,1795772380,0.001428151,1.60E-01,50530.94777,757256783.4,1.14E+13,17721962,21492230,1792002112,14152,10109,34260
13499,38946,34963,0.00082487,0.005,433667,6808399,525732054,1361668998,471965537,1.84E+13,1887401052,4.12E-06,5.82E-03,1946.551063,75810377.68,2.95E+12,7242066,1362102665,532540453,40469,7348,105920
139920,39416,1928,0.00019487,0.2,1074756,15202048,5515086720,75994048,269765760,1.06E+13,5591080768,3.90E-05,2.00E-01,10513.85073,414413940.4,1.63E+13,16276804,77068804,5530288768,9523,27114,18082
118113,63168,1877,0.00491597,0.27,36678218,32014833,7460961984,118566336,221698101,1.40E+13,7579528320,0.001327312,2.75E-01,294262.5277,18587975348,1.17E+15,68693051,155244554,7492976817,204898,196682,485962
38901,3854,43891,0.00108175,0.3,162196,50751830,149924454,169155914,1707403791,6.58E+12,319080368,0.000324525,3.01E-01,554095.2153,2135482960,8.23E+12,50914026,169318110,200676284,38007,130032,28175
116768,68224,6487,0.00491597,0.07,39163128,30982527,7966380032,442569088,757474016,5.17E+13,8408949120,0.000344118,7.49E-02,260660.3677,17783292925,1.21E+15,70145655,481732216,7997362559,753570,223395,1713565
52392,2000,17644,0.02533638,0.2,2655227,7058675,104784000,35288000,924404448,1.85E+12,140072000,0.005067276,2.25E-01,4684212.474,9368424947,1.87E+13,9713902,37943227,111842675,65572,137324,248432
143170,72851,5332,0.00015297,0.13,1595504,50497653,10430077670,388441532,763382440,5.56E+13,10818519202,1.99E-05,1.30E-01,15180.69954,1105929142,8.06E+13,52093157,390037036,10480575323,44382,76801,73901
38557,54026,22112,0.00018467,0.03,384695,35840441,2083080482,1194622912,852572384,4.61E+13,3277703394,5.54E-06,3.02E-02,4723.336265,255182965,1.38E+13,36225136,1195007607,2118920923,44877,19868,49721
44485,16752,5113,0.00018467,0.3,137625,25701076,745212720,85652976,227451805,3.81E+12,830865696,5.54E-05,3.00E-01,12601.05745,211092914.4,3.54E+12,25838701,85790601,770913796,12345,12894,11983
62792,45902,1805,0.00041097,0.3,1184551,24861976,2882278384,82853110,113339560,5.20E+12,2965131494,0.000123291,3.00E-01,13973.74769,641422966.6,2.95E+13,26046527,84037661,2907140360,4206,17457,19173
95682,28543,1972,0.00047003,0.23,1283700,12948869,2731051326,56286796,188684904,5.39E+12,2787338122,0.000108107,2.30E-01,20398.14005,582224111.4,1.66E+13,14232569,57570496,2744000195,5568,23495,17927
49881,6891,20796,0.00082487,0.17,283538,24362044,343729971,143305236,1037325276,7.15E+12,487035207,0.000140228,1.71E-01,145461.9451,1002378263,6.91E+12,24645582,143588774,368092015,24131,66033,46137
12352,12468,17608,0.02533638,0.17,3902395,37324854,154004736,219536544,217494016,2.71E+12,373541280,0.004307185,1.95E-01,936786.8763,11679858774,1.46E+14,41227249,223438939,191329590,94922,102809,356481
11199,26434,11001,0.02533638,0.13,7500968,37806953,296034366,290800434,123200199,3.26E+12,586834800,0.003293729,1.55E-01,405788.1175,10726603099,2.84E+14,45307921,298301402,333841319,101110,78366,438272
51832,91023,2937,0.00019487,0.13,919394,34762377,4717904136,267334551,152230584,1.39E+13,4985238687,2.53E-05,1.30E-01,3856.472608,351027706.2,3.20E+13,35681771,268253945,4752666513,7254,16514,19434
62262,12569,11875,0.00108175,0.005,846595,746346,782571078,149256875,739361250,9.29E+12,931827953,5.41E-06,6.08E-03,3999.020161,50263684.4,6.32E+11,1592941,150103470,783317424,20556,3183,63086
143052,52536,2399,0.00078778,0.07,5920522,8823825,7515379872,126033864,343181748,1.80E+13,7641413736,5.51E-05,7.08E-02,18924.62022,994223847.9,5.22E+13,14744347,131954386,7524203697,54997,47971,117440
80027,15153,11376,0.00078778,0.2,955350,34478646,1212649131,172380528,910387152,1.38E+13,1385029659,0.000157556,2.01E-01,143436.9581,2173500226,3.29E+13,35433996,173335878,1247127777,35624,109140,71745
115963,36450,9188,0.00015297,0.2,646590,66987116,4226851350,334902600,1065468044,3.88E+13,4561753950,3.06E-05,2.00E-01,32596.92934,1188158074,4.33E+13,67633706,335549190,4293838466,31639,115555,54605
41430,11930,28171,2.09E-05,0.2,10320,67221162,494259900,336080030,1167124530,1.39E+13,830339930,4.18E-06,2.00E-01,4873.912037,58145770.6,6.94E+11,67231482,336090350,561481062,34839,4985,27315
41846,72699,6721,0.00370564,0.01,11273405,4886774,3042162354,488609979,281246966,2.04E+13,3530772333,3.71E-05,1.37E-02,10422.00007,757668983.2,5.51E+13,16160179,499883384,3047049128,115867,34504,414479
37623,1710,39221,0.00108175,0.3,69604,20122893,64335330,67067910,1475611683,2.52E+12,131403240,0.000324525,3.01E-01,478872.8814,818872627.2,1.40E+12,20192497,67137514,84458223,17875,53721,30502
111901,76334,779,0.00056263,0.23,4805928,13678481,8541850934,59464186,87170879,6.65E+12,8601315120,0.000129405,2.31E-01,11280.33888,861073388.1,6.57E+13,18484409,64270114,8555529415,10459,22076,28108
22104,24818,5378,0.00182521,0.25,1001316,33370838,548577072,133471204,118875312,2.95E+12,682048276,0.000456303,2.52E-01,54243.10205,1346205307,3.34E+13,34372154,134472520,581947910,7720,17757,37967
121480,16530,4479,0.00108175,0.23,2172316,17030235,2008064400,74037870,544108920,8.99E+12,2082102270,0.000248803,2.31E-01,135375.6596,2237759653,3.70E+13,19202551,76210186,2025094635,29544,84578,72429
22778,10815,19643,0.00056263,0.13,138607,27618796,246344070,212439045,447428254,4.84E+12,458783115,7.31E-05,1.31E-01,32725.75261,353929014.5,3.83E+12,27757403,212577652,273962866,13860,28763,26196
23703,22268,4497,0.00078778,0.15,415822,15023582,527818404,100139196,106592391,2.37E+12,627957600,0.000118167,1.51E-01,12595.70307,280481115.9,6.25E+12,15439404,100555018,542841986,4190,10299,12420
81401,45610,6643,0.00108175,0.17,4016255,51508589,3712699610,302987230,540746843,2.47E+13,4015686840,0.000183898,1.71E-01,99441.99256,4535549281,2.07E+14,55524844,307003485,3764208199,69294,105952,159583
16040,39396,27507,0.00952101,0.001,6016511,1083671,631911840,1083665772,441212280,1.74E+13,1715577612,9.52E-06,1.05E-02,4200.78653,165494186.1,6.52E+12,7100182,1089682283,632995511,235257,11554,881754
4161,12489,19123,0.01084252,0.17,563597,40603716,51966729,238827147,79570803,9.94E+11,290793876,0.001843228,1.81E-01,146667.1639,1831726210,2.29E+13,41167313,239390744,92570445,14011,18523,59470
110866,73534,17656,0.00182521,0.01,14880151,12983882,8152420444,1298316304,1957450096,1.44E+14,9450736748,1.83E-05,1.18E-02,35727.5749,2627191492,1.93E+14,27864033,1313196455,8165404326,755860,181982,1820858
99144,97504,3991,0.00163948,0.15,15848898,58377287,9666936576,389138464,395683704,3.86E+13,10056075040,0.000245922,1.52E-01,97307.32786,9487853695,9.25E+14,74226185,404987362,9725313863,158802,131483,399966
52305,19935,7537,0.00296184,0.17,3088399,25546284,1042700175,150250095,394222785,7.86E+12,1192950270,0.000503513,1.73E-01,198496.2183,3957022112,7.89E+13,28634683,153338494,1068246459,44282,70912,127442
66190,3277,16927,0.00082282,0.15,178484,8321213,216904630,55469779,1120398130,3.67E+12,272374409,0.000123423,1.51E-01,138282.8984,453153058.1,1.49E+12,8499697,55648263,225225843,14209,33036,28233
12228,10281,22617,0.00013363,0.23,16801,53483788,125716068,232525377,276560676,2.84E+12,358241445,3.07E-05,2.30E-01,8500.064721,87389165.39,8.99E+11,53500589,232542178,179199856,19699,6471,6127
144319,38023,7918,0.00860544,0.005,47222253,1505374,5487441337,301066114,1142717842,4.34E+13,5788507451,4.30E-05,1.36E-02,49167.94913,1869512930,7.11E+13,48727627,348288367,5488946711,1234024,106462,2630790
89931,29792,8757,0.00860544,0.23,23056524,60007616,2679224352,260888544,787525767,2.35E+13,2940112896,0.001979251,2.39E-01,1558711.319,46437127627,1.38E+15,83064140,283945068,2739231968,486978,477102,1194768
51594,92721,20107,0.00296184,0.01,14169019,18644313,4783847274,1864341147,1037400558,9.62E+13,6648188421,2.96E-05,1.30E-02,30726.14469,2848958862,2.64E+14,32813332,1878510166,4802491587,477089,128927,1550798
54986,14587,17892,0.00013363,0.15,107182,39148904,802080782,260990604,983809512,1.44E+13,1063071386,2.00E-05,1.50E-01,19719.96976,287655198.9,4.20E+12,39256086,261097786,841229686,19998,26793,30547
84555,83918,22255,0.00182521,0.03,12951257,56030479,7095686490,1867595090,1881771525,1.58E+14,8963281580,5.48E-05,3.18E-02,103038.8462,8646813892,7.26E+14,68981736,1880546347,7151716969,648800,306278,1733734
114116,19946,2585,0.00160539,0.27,3654144,13923102,2276157736,51560410,294989860,5.88E+12,2327718146,0.000433455,2.72E-01,127864.9183,2550393660,5.09E+13,17577246,55214554,2290080838,28996,55910,73057
71630,54634,1408,0.00296184,0.3,11591069,23091874,3913433420,76924672,100855040,5.51E+12,3990358092,0.000888552,3.03E-01,89614.9475,4896023042,2.68E+14,34682943,88515741,3936525294,28668,49367,93014
18829,7341,36671,0.02533638,0.25,3502645,67309410,138223689,269201811,690478259,5.07E+12,407425500,0.006334095,2.75E-01,4373554.888,32106266432,2.36E+14,70812055,272704456,205533099,182188,247841,666427
26889,71999,9831,0.00370564,0.01,7174091,7078480,1935981111,707822169,264345759,1.90E+13,2643803280,3.71E-05,1.37E-02,9795.702184,705280761.5,5.08E+13,14252571,714996260,1943059591,106373,29793,378972
128577,13435,1547,0.00860544,0.23,14865353,4781979,1727431995,20783945,198908619,2.67E+12,1748215940,0.001979251,2.39E-01,393690.1228,5289226800,7.11E+13,19647332,35649298,1732213974,69849,59866,154137
94579,26926,7130,0.00182521,0.27,4648272,51843188,2546634154,191982380,674348270,1.82E+13,2738616534,0.000492807,2.72E-01,332323.3456,8948138403,2.41E+14,56491460,196630652,2598477342,96287,158399,210221
89300,62672,2675,0.00370564,0.2,20739217,33537183,5596609600,167647600,238877500,1.50E+13,5764257200,0.000741128,2.04E-01,177038.8038,11095375913,6.96E+14,54276400,188386817,5630146783,152981,126078,344275
99044,73254,1425,0.00296184,0.15,21489714,15659006,7255369176,104386950,141137700,1.03E+13,7359756126,0.000444276,1.53E-01,62704.09281,4593325614,3.37E+14,37148720,125876664,7271028182,79985,60919,197743
9399,66337,15140,0.00013363,0.03,83327,30132156,623501463,1004342180,142300860,9.44E+12,1627843643,4.01E-06,3.01E-02,570.4699177,37843262.93,2.51E+12,30215483,1004425507,653633619,13616,3220,19768
50934,66250,15893,0.00491597,0.03,16588394,31588707,3374377500,1052911250,809494062,5.36E+13,4427288750,0.000147479,3.49E-02,119383.4557,7909153941,5.24E+14,48177101,1069499644,3405966207,415649,166783,1429942
74758,70969,1479,0.00031941,0.15,1694668,15753736,5305500502,104963151,110567082,7.85E+12,5410463653,4.79E-05,1.50E-01,5297.434749,375953646.7,2.67E+13,17448404,106657819,5321254238,5916,20893,17385
86717,41736,3127,0.00078778,0.13,2851196,16971095,3619220712,130508472,271164059,1.13E+13,3749729184,0.000102411,1.31E-01,27770.29091,1159020861,4.84E+13,19822291,133359668,3636191807,25575,44749,57095
134963,50115,3152,0.00018467,0.15,1249062,23699508,6763670745,157962480,425403376,2.13E+13,6921633225,2.77E-05,1.50E-01,11783.88622,590549457.8,2.96E+13,24948570,159211542,6787370253,18037,40413,33561
46242,36529,1934,0.00082282,0.2,1389925,14131215,1689174018,70647086,89432028,3.27E+12,1759821104,0.000164564,2.01E-01,14717.29226,537607968.8,1.96E+13,15521140,72037011,1703305233,4796,13070,16240
119596,15184,2537,0.00952101,0.17,17289871,6549136,1815945664,38521808,303415052,4.61E+12,1854467472,0.001618572,1.80E-01,491099.0165,7456847467,1.13E+14,23839007,55811679,1822494800,130484,107167,296533
39751,9041,20031,0.00018467,0.2,66377,36224403,359388791,181100271,796252281,7.20E+12,540489062,3.69E-05,2.00E-01,29408.78175,265884795.8,2.40E+12,36290780,181166648,395613194,18206,25557,24320
50024,20037,8913,0.00182521,0.27,1829576,48222376,1002330888,178589781,445863912,8.93E+12,1180920669,0.000492807,2.72E-01,219724.7231,4402624277,8.82E+13,50051952,180419357,1050553264,38775,84144,91616
77588,7012,13176,0.00108175,0.17,588548,15707328,544047056,92390112,1022299488,7.17E+12,636437168,0.000183898,1.71E-01,187998.3201,1318244221,9.24E+12,16295876,92978660,559754384,22254,76503,54712
121993,53221,11925,0.00019487,0.005,1265219,3173431,6492589453,634660425,1454766525,7.74E+13,7127249878,9.74E-07,5.19E-03,1417.451764,75438200.31,4.02E+12,4438650,635925644,6495762884,46833,5798,128483
126989,67460,7212,0.00041097,0.13,3520680,63253426,8566677940,486521520,915844668,6.18E+13,9053199460,5.34E-05,1.30E-01,48930.00882,3300818395,2.23E+14,66774106,490042200,8629931366,102350,142897,199807
115832,21498,17887,0.00108175,0.15,2693822,57682133,2490156336,384534726,2071886984,4.45E+13,2874691062,0.000162263,1.51E-01,336189.5617,7227403198,1.55E+14,60375955,387228548,2547838469,149099,304753,337909
51310,66327,13468,8.43E-05,0.07,286863,62532293,3403238370,893292036,691043080,4.58E+13,4296530406,5.90E-06,7.01E-02,4077.361485,270439155.2,1.79E+13,62819156,893578899,3465770663,39139,33783,60193
131972,55300,2384,8.43E-05,0.25,615158,32968910,7298051600,131835200,314621248,1.74E+13,7429886800,2.11E-05,2.50E-01,6629.856248,366631050.5,2.03E+13,33584068,132450358,7331020510,16749,32219,14840
13603,10089,26357,8.43E-05,0.15,11568,39888940,137240667,265915773,358534271,3.62E+12,403156440,1.26E-05,1.50E-01,4533.128055,45734728.95,4.61E+11,39900508,265927341,177129607,3757,3763,6336
8877,3484,43992,0.00031941,0.3,9881,45990272,30927468,153268128,390516984,1.36E+12,184195596,9.58E-05,3.00E-01,37420.50896,130373053.2,4.54E+11,46000153,153278009,76917740,19359,8109,16409
113491,42518,3849,0.00163948,0.2,7911293,32733423,4825410338,163651782,436826859,1.86E+13,4989062120,0.000327896,2.02E-01,143233.7798,6090013848,2.59E+14,40644716,171563075,4858143761,102140,113186,210519
50762,86228,9706,0.01084252,5.00E-04,47459485,418503,4377105736,836928968,492695972,4.25E+13,5214034704,5.42E-06,1.13E-02,2671.032965,230317830.5,1.99E+13,47877988,884388453,4377524239,723059,11979,2416551
145187,329,915,0.02533638,0.07,1213491,21132,47766523,301035,132846105,43706368545,48067558,0.001773547,9.53E-02,235608.7578,77515281.33,25643491812,1234623,1514526,47787655,3463,4018,3525
37622,36955,6996,0.00163948,0.15,2279445,38783402,1390321010,258537180,263203512,9.73E+12,1648858190,0.000245922,1.52E-01,64727.53408,2392006022,8.84E+13,41062847,260816625,1429104412,23146,48353,89328
42382,53674,3279,0.00056263,0.2,1279906,35208943,2274811468,175997046,138970578,7.46E+12,2450808514,0.000112526,2.01E-01,15637.80326,839343452.2,4.51E+13,36488849,177276952,2310020411,7634,18861,33676
87665,48729,17510,0.00296184,5.00E-04,12652686,426640,4271827785,853244790,1535014150,7.48E+13,5125072575,1.48E-06,3.46E-03,2273.233155,110772378.4,5.40E+12,13079326,865897476,4272254425,495255,9790,1316121
81183,42831,5905,0.00082185,0.05,2857768,12647276,3477149073,252917055,479385615,2.05E+13,3730066128,4.11E-05,5.08E-02,19699.15338,843734438.6,3.61E+13,15505044,255774823,3489796349,38783,50413,108422
58665,5597,29984,0.02533638,0.15,8319487,25174495,328348005,167820448,1759011360,9.85E+12,496168453,0.003800457,1.75E-01,6685047.036,37416208262,2.09E+14,33493982,176139935,353522500,390087,403301,1315589
45905,49663,2602,0.00082487,0.15,1880558,19387924,2279780015,129223126,119444810,5.93E+12,2409003141,0.000123731,1.51E-01,14778.96606,733967791.6,3.65E+13,21268482,131103684,2299167939,7732,16608,28578
119068,16505,16260,0.00108175,0.13,2126011,34892418,1965217340,268371300,1936045680,3.20E+13,2233588640,0.000140628,1.31E-01,272261.2639,4493672160,7.42E+13,37018429,270497311,2000109758,100324,232630,252763
37912,55799,16428,0.00041097,0.03,869404,27501373,2115451688,916665972,622818336,3.48E+13,3032117660,1.23E-05,3.04E-02,7678.789546,428468777.9,2.39E+13,28370777,917535376,2142953061,31704,35274,102659
29273,47975,30238,0.00018467,0.01,259353,14507068,1404372175,1450668050,885156974,4.25E+13,2855040225,1.85E-06,1.02E-02,1634.619384,78420864.94,3.76E+12,14766421,1450927403,1418879243,40627,9360,78623
94087,88687,10808,0.00082185,0.07,6857851,67103577,8344293769,958529096,1016892296,9.02E+13,9302822865,5.75E-05,7.08E-02,58501.30534,5188305267,4.60E+14,73961428,965386947,8411397346,203999,207818,476947
108444,591,18014,0.01084252,0.1,694959,1064736,64090404,10646274,1953510216,1.15E+12,74736678,0.001084252,1.11E-01,2118097.359,1251795539,7.40E+11,1759695,11341233,65155140,32534,66910,88239
25990,4298,32818,0.00019487,0.27,21773,38093822,111705020,141051764,852939820,3.67E+12,252756784,5.26E-05,2.70E-01,44877.34334,192882821.7,8.29E+11,38115595,141073537,149798842,21544,20527,26381
141815,72084,4985,0.00182521,0.15,18658731,53907250,10222592460,359338740,706947775,5.10E+13,10581931200,0.000273782,1.52E-01,193549.2223,13951802137,1.01E+15,72565981,377997471,10276499710,362039,228512,680403
81769,27614,21821,0.00160539,0.05,3624945,30128791,2257969166,602565094,1784281349,4.93E+13,2860534260,8.03E-05,5.16E-02,143223.3717,3954970187,1.09E+14,33753736,606190039,2288097957,156855,189688,470356
113223,10018,11357,0.00082487,0.23,935663,26169939,1134268014,113774426,1285873611,1.29E+13,1248042440,0.00018972,2.31E-01,243956.0701,2443951910,2.45E+13,27105602,114710089,1160437953,37470,138725,79329
45618,54388,7874,0.01084252,0.07,26901567,29979312,2481071784,428251112,359196132,1.95E+13,2909322896,0.000758976,8.08E-02,272621.3872,14827332005,8.06E+14,56880879,455152679,2511051096,330980,141955,1080030
63894,38439,4471,0.00860544,0.27,21135422,46407078,2456021466,171860769,285670074,1.10E+13,2627882235,0.002323469,2.79E-01,663745.504,25513713430,9.81E+14,67542500,192996191,2502428544,169961,211908,486512
106923,44899,8525,0.01084252,0.15,52052697,57416751,4800735777,382763975,911518575,4.09E+13,5183499752,0.001626378,1.61E-01,1482473.757,66561589214,2.99E+15,109469448,434816672,4858152528,1184739,712082,2760805
37515,49256,17206,0.00082282,0.07,1520477,59327094,1847838840,847498736,645483090,3.18E+13,2695337576,5.76E-05,7.08E-02,37178.14773,1831246844,9.02E+13,60847571,849019213,1907165934,64578,82099,175401
32352,73752,28061,0.00163948,0.01,3911935,20695721,2386024704,2069554872,907829472,6.70E+13,4455579576,1.64E-05,1.16E-02,14883.68263,1097701361,8.10E+13,24607656,2073466807,2406720425,174420,75940,594605
19053,5909,27521,0.00031941,0.17,35965,27650357,112584177,162621589,524357613,3.10E+12,275205766,5.43E-05,1.70E-01,28472.46108,168243772.5,9.94E+11,27686322,162657554,140234534,15847,10775,16635
142193,76384,6370,1.65E-05,0.07,179321,34060442,10861270112,486566080,905769410,6.92E+13,11347836192,1.16E-06,7.00E-02,1046.797707,79958596.06,6.11E+12,34239763,486745401,10895330554,26112,14944,27202
53503,57268,1850,0.00860544,0.3,26367431,31798087,3064009804,105945800,98980550,5.67E+12,3169955604,0.002581632,3.09E-01,255531.3553,14633769653,8.38E+14,58165518,132313231,3095807891,72508,107265,250221
93935,73922,13905,0.00034241,0.005,2377694,5139488,6943863070,1027885410,1306166175,9.66E+13,7971748480,1.71E-06,5.34E-03,2236.2218,165305987.9,1.22E+13,7517182,1030263104,6949002558,77431,14305,228101
18107,12950,22537,0.00015297,0.23,35872,67129085,234485650,291854150,408077459,5.28E+12,526339800,3.52E-05,2.30E-01,14357.43005,185928719.1,2.41E+12,67164957,291890022,301614735,33063,26974,9846
1882,96408,20517,0.00082282,0.03,149344,59340961,181439856,1978002936,38612994,3.72E+12,2159442792,2.47E-05,3.08E-02,953.1463117,91890929.62,8.86E+12,59490305,1978152280,240780817,27235,4887,42025
111945,49638,6764,0.01084252,0.01,60249528,3357904,5556725910,335751432,757195980,3.76E+13,5892477342,0.000108425,2.08E-02,82099.12557,4075236395,2.02E+14,63607432,396000960,5560083814,1071806,134543,2551712
38161,17898,18304,0.00056263,0.15,384302,49144312,683005578,327604992,698498944,1.25E+13,1010610570,8.44E-05,1.51E-01,58949.46913,1055077598,1.89E+13,49528614,327989294,732149890,33311,62884,46874
23590,50019,790,0.01084252,0.3,12793700,11868472,1179948210,39515010,18636100,9.32E+11,1219463220,0.003252756,3.11E-01,60618.68609,3032086060,1.52E+14,24662172,52308710,1191816682,13706,21601,51898
44607,19677,39166,0.00952101,0.005,8357244,3853527,877731939,770669382,1747077762,3.44E+13,1648401321,4.76E-05,1.45E-02,83169.72421,1636530663,3.22E+13,12210771,779026626,881585466,477671,92943,1688947
25512,3189,29064,0.02533638,0.03,2061768,2781105,81357768,92685096,741480768,2.36E+12,174042864,0.000760091,5.53E-02,563593.155,1797298571,5.73E+12,4842873,94746864,84138873,73782,61628,304982
69020,29619,10640,0.00160539,0.05,3281969,15758694,2044303380,315146160,734372800,2.18E+13,2359449540,8.03E-05,5.16E-02,58947.73747,1745973036,5.17E+13,19040663,318428129,2060062074,63950,82509,198465
11367,36617,26881,0.00041097,0.01,171068,9843198,416225439,984301577,305556327,1.12E+13,1400527016,4.11E-06,1.04E-02,1255.744837,45981608.7,1.68E+12,10014266,984472645,426068637,20275,3148,45305
46820,35088,10000,0.00056263,0.13,924313,45617340,1642820160,350880000,468200000,1.64E+13,1993700160,7.31E-05,1.31E-01,34245.03758,1201589879,4.22E+13,46541653,351804313,1688437500,16832,59092,56663
38268,81011,14807,0.00047003,0.03,1457165,35986213,3100128948,1199529877,566634276,4.59E+13,4299658825,1.41E-05,3.05E-02,7990.053262,647282204.8,5.24E+13,37443378,1200987042,3136115161,43058,46217,147897
132093,55926,7122,0.00082282,0.15,6078625,59750458,7387433118,398304972,940766346,5.26E+13,7785738090,0.000123423,1.51E-01,116112.2047,6493691161,3.63E+14,65829083,404383597,7447183576,160321,201807,326035
51899,68702,24643,0.00082487,0.005,2941198,8465346,3565565098,1693023386,1278947057,8.79E+13,5258588484,4.12E-06,5.82E-03,5274.825295,362391047.4,2.49E+13,11406544,1695964584,3574030444,121013,27109,413429
18531,49721,8755,0.00056263,0.07,518413,30473466,921379851,435307355,162238905,8.07E+12,1356687206,3.94E-05,7.06E-02,6389.633258,317698955.2,1.58E+13,30991879,435825768,951853317,10840,15634,30314
100503,41730,17765,0.00082282,0.001,3450970,741384,4193990190,741333450,1785435795,7.45E+13,4935323640,8.23E-07,1.82E-03,1469.092281,61305220.88,2.56E+12,4192354,744784420,4194731574,145298,3884,407447
124443,1564,13001,0.00860544,0.13,1675223,2644071,194628852,20333564,1617883443,2.53E+12,214962416,0.001118707,1.39E-01,1809937.856,2830742807,4.43E+12,4319294,22008787,197272923,49398,135082,147560
534,13928,46240,0.00078778,0.1,5865,64406972,7437552,644030720,24692160,3.44E+11,651468272,7.88E-05,1.01E-01,1945.19898,27092731.4,3.78E+11,64412837,644036585,71844524,3492,3056,6862
54171,69049,4887,0.00952101,0.2,35613115,67501922,3740453379,337442463,264733677,1.83E+13,4077895842,0.001904202,2.10E-01,504106.3972,34808042621,2.40E+15,103115037,373055578,3807955301,300309,263237,889858
77181,35387,4599,0.00015297,0.13,417799,21158611,2731204047,162744813,354955419,1.26E+13,2893948860,1.99E-05,1.30E-01,7058.678958,249785472.3,8.84E+12,21576410,163162612,2752362658,14238,16480,24822
107023,12778,6673,0.01084252,0.23,14828725,19615203,1367539894,85267594,714164479,9.13E+12,1452807488,0.00249378,2.41E-01,1780968.809,22757219439,2.91E+14,34443928,100096319,1387155097,249153,264912,603895
26151,48158,4480,0.00370564,0.005,4666996,1078821,1259379858,215747840,117156480,5.64E+12,1475127698,1.85E-05,8.71E-03,2170.698693,104536507.6,5.03E+12,5745817,220414836,1260458679,28736,5921,110020
5039,15645,35277,0.00082282,0.1,64872,55191732,78835155,551908665,177760803,2.78E+12,630743820,8.23E-05,1.01E-01,14626.51439,228831817.7,3.58E+12,55256604,551973537,134026887,10211,12864,20941
142799,91268,3641,0.00019487,0.2,2539749,66471738,13032979132,332306788,519931159,4.75E+13,13365285920,3.90E-05,2.00E-01,20263.79699,1849436224,1.69E+14,69011487,334846537,13099450870,54365,86090,72686
66970,42015,17454,0.00034241,0.07,963482,51334084,2813744550,733329810,1168894380,4.91E+13,3547074360,2.40E-05,7.03E-02,28016.87873,1177129160,4.95E+13,52297566,734293292,2865078634,56459,82683,125932
90343,3655,18815,0.00108175,0.2,357278,13757150,330203665,68768825,1699803545,6.21E+12,398972490,0.00021635,2.01E-01,367752.497,1344135376,4.92E+12,14114428,69126103,343960815,25967,82586,54877
91534,90483,8372,0.00056263,0.005,4659902,3787658,8282270922,757523676,766322648,6.93E+13,9039794598,2.81E-06,5.56E-03,2155.780557,195061492.2,1.77E+13,8447560,762183578,8286058580,93334,14965,255064
89398,60028,20137,0.00952101,5.00E-04,51094075,604412,5366383144,1208783836,1800207526,1.08E+14,6575166980,4.76E-06,1.00E-02,8569.896929,514433772.8,3.09E+13,51698487,1259877911,5366987556,2301706,36508,5881714
96832,17872,6773,0.00082487,0.15,1427529,18159347,1730581504,121047056,655843136,1.17E+13,1851628560,0.000123731,1.51E-01,81147.79914,1450273466,2.59E+13,19586876,122474585,1748740851,27585,84182,66658
128372,79220,6917,0.00047003,0.03,4780060,16440271,10169629840,547964740,887949124,7.03E+13,10717594580,1.41E-05,3.05E-02,12520.8818,991904256.4,7.86E+13,21220331,552744800,10186070111,108521,73866,257517
88618,85186,4158,0.00082282,0.005,6211553,1771071,7549012948,354203388,368473644,3.14E+13,7903216336,4.11E-06,5.82E-03,1515.937419,129136645,1.10E+13,7982624,360414941,7550784019,61762,11797,162813
112303,45995,9913,2.09E-05,0.1,107854,45596748,5165376485,455948435,1113259639,5.12E+13,5621324920,2.09E-06,1.00E-01,2324.486126,106914739.4,4.92E+12,45704602,456056289,5210973233,31746,19662,39521
60438,8929,15095,0.00108175,0.27,583790,36393207,539650902,134783255,912311610,8.15E+12,674434157,0.000292073,2.71E-01,266461.1327,2379231454,2.12E+13,36976997,135367045,576044109,31308,108581,56248
42770,49462,28457,0.01084252,0.01,22937950,14076127,2115489740,1407540134,1217105890,6.02E+13,3523029874,0.000108425,2.08E-02,131964.9495,6527250334,3.23E+14,37014077,1430478084,2129565867,952512,169504,3363121
13828,42270,43148,0.01084252,5.00E-04,6337939,911958,584509560,1823865960,596650544,2.52E+13,2408375520,5.42E-06,1.13E-02,3234.597728,136726446,5.78E+12,7249897,1830203899,585421518,357296,9830,1418460
78999,60750,8504,0.00182521,0.01,8759666,5166703,4799189250,516618000,671807496,4.08E+13,5315807250,1.83E-05,1.18E-02,12261.8976,744910279.1,4.53E+13,13926369,525377666,4804355953,139352,50558,419761
16672,417,36969,0.00491597,0.15,34197,2313742,6952224,15416073,616347168,2.57E+11,22368297,0.000737396,1.55E-01,454491.6281,189523008.9,79123035174,2347939,15450270,9265966,5789,11547,10632
75568,16383,12784,0.00047003,0.2,581926,41891097,1238030544,209440272,966061312,1.58E+13,1447470816,9.40E-05,2.00E-01,90815.5597,1487831314,2.44E+13,42473023,210022198,1279921641,35713,92044,51877
97236,43938,16814,0.00019487,0.07,832563,51714974,4272355368,738773532,1634926104,7.18E+13,5011128900,1.36E-05,7.02E-02,22301.86349,979899278.1,4.31E+13,52547537,739606095,4324070342,58528,102600,127733
59960,96891,15808,0.00013363,0.03,776342,45951036,5809584360,1531652928,947847680,9.18E+13,7341237288,4.01E-06,3.01E-02,3799.826564,368168995.6,3.57E+13,46727378,1532429270,5855535396,55975,38133,95269
35846,61657,3717,0.00031941,0.15,705954,34379891,2210156822,229179069,133239582,8.22E+12,2439335891,4.79E-05,1.50E-01,6383.708233,393600298.5,2.43E+13,35085845,229885023,2244536713,6199,15624,17634
68113,13437,20825,0.00041097,0.17,376160,47574732,915234381,279825525,1418453225,1.91E+13,1195059906,6.99E-05,1.70E-01,99100.09272,1331607946,1.79E+13,47950892,280201685,962809113,31145,108063,64370
50356,4068,16876,0.00041097,0.25,84193,17164582,204848208,68651568,849807856,3.46E+12,273499776,0.000102743,2.50E-01,87311.38365,355182708.7,1.45E+12,17248775,68735761,222012790,11223,24212,21847
119923,10303,10249,0.00491597,0.13,6074116,13728464,1235566669,105595447,1229090827,1.27E+13,1341162116,0.000639076,1.35E-01,785482.5723,8092826942,8.34E+13,19802580,111669563,1249295133,174131,194588,407121
20934,24889,3564,0.00160539,0.13,836506,11532585,521026326,88704396,74608776,1.86E+12,609730722,0.000208701,1.32E-01,15570.90378,387544224.1,9.65E+12,12369091,89540902,532558911,5053,12540,17103
132120,96192,6405,1.65E-05,0.05,209826,30806895,12708887040,616109760,846228600,8.14E+13,13324996800,8.26E-07,5.00E-02,698.5617093,67196047.94,6.46E+12,31016721,616319586,12739693935,27659,6377,35291
10790,12194,40234,0.00018467,0.13,24300,63785073,131573260,490613396,434124860,5.29E+12,622186656,2.40E-05,1.30E-01,10422.07893,127086830.4,1.55E+12,63809373,490637696,195358333,7522,8820,12896
2722,44253,7025,0.00182521,0.15,219888,46638421,120456666,310877325,19122050,8.46E+11,431333991,0.000273782,1.52E-01,5235.263532,231676117.1,1.03E+13,46858309,311097213,167095087,6079,4172,13020
105590,56113,7015,0.00082282,0.01,4875209,3936776,5924971670,393632695,740713850,4.16E+13,6318604365,8.23E-06,1.08E-02,6094.741701,341994241,1.92E+13,8811985,398507904,5928908446,100157,30323,234804
70048,28008,26539,0.00082185,0.05,1612399,37166650,1961904384,743304312,1859003872,5.21E+13,2705208696,4.11E-05,5.08E-02,76391.11661,2139562394,5.99E+13,38779049,744916711,1999071034,91896,152568,268499
100808,17638,14925,0.00082282,0.2,1463054,52651214,1778051504,263247150,1504559400,2.65E+13,2041298654,0.000164564,2.01E-01,247596.3131,4367103770,7.70E+13,54114268,264710204,1830702718,58711,209877,153153
84676,19530,17106,0.00108175,0.2,1788961,66819509,1653722280,334080180,1448467656,2.83E+13,1987802460,0.00021635,2.01E-01,313375.9774,6120232838,1.20E+14,68608470,335869141,1720541789,86451,224688,191595
129536,95059,1952,0.00078778,0.17,9700462,31551020,12313562624,185555168,252854272,2.40E+13,12499117792,0.000133923,1.71E-01,33862.90153,3218973556,3.06E+14,41251482,195255630,12345113644,81077,72505,141395
65163,9342,6235,0.00082282,0.03,500927,1747705,608752746,58247370,406291305,3.80E+12,667000116,2.47E-05,3.08E-02,10029.13835,93692210.44,8.75E+11,2248632,58748297,610500451,8758,7724,22300
59101,62115,32953,0.00860544,5.00E-04,31591547,1023447,3671058615,2046875595,1947555253,1.21E+14,5717934210,4.30E-06,9.11E-03,8379.784938,520510341.4,3.23E+13,32614994,2078467142,3672082062,1649608,33283,5528475
58225,64324,30532,0.00860544,0.03,32230464,58919556,3745264900,1963940368,1777725700,1.14E+14,5709205268,0.000258163,3.86E-02,458943.3554,29521072395,1.90E+15,91150020,1996170832,3804184456,1607057,435324,5270161
50680,25677,28317,0.00491597,0.01,6397329,7271102,1301310360,727095609,1435105560,3.68E+13,2028405969,4.92E-05,1.49E-02,70549.3588,1811495886,4.65E+13,13668431,733492938,1308581462,286378,104325,971569
138502,70304,8703,0.00163948,0.03,15964237,18356833,9737244608,611855712,1205382906,8.47E+13,10349100320,4.92E-05,3.16E-02,59286.035,4168045405,2.93E+14,34321070,627819949,9755601441,515629,178173,1024345
35614,57724,23989,0.00019487,0.03,400623,41543475,2055782536,1384741036,854344246,4.93E+13,3440523572,5.85E-06,3.02E-02,4994.581897,288307245.4,1.66E+13,41944098,1385141659,2097326011,49675,30970,97253
52019,19591,23435,0.00296184,0.01,3018553,4591472,1019104229,459115085,1219065265,2.39E+13,1478219314,2.96E-05,1.30E-02,36106.76264,707367587,1.39E+13,7610025,462133638,1023695701,110283,47088,389523
137556,87265,2160,0.00041097,0.05,4933228,9425754,12003824340,188492400,297120960,2.59E+13,12192316740,2.05E-05,5.04E-02,6105.390047,532786862.4,4.65E+13,14358982,193425628,12013250094,41634,34261,90963
91220,60873,7368,2.48E-05,0.15,137880,67281482,5552835060,448512264,672108960,4.09E+13,6001347324,3.72E-06,1.50E-01,2503.269822,152381543.8,9.28E+12,67419362,448650144,5620116542,39264,35082,31207
146306,88028,7276,8.43E-05,0.01,1085579,6405159,12879024568,640491728,1064522456,9.37E+13,13519516296,8.43E-07,1.01E-02,897.2859782,78986290.09,6.95E+12,7490738,641577307,12885429727,31628,8953,80415
14556,57246,26971,0.00370564,0.03,3087915,46321340,833272776,1543981866,392589876,2.25E+13,2377254642,0.000111169,3.37E-02,43643.90244,2498438839,1.43E+14,49409255,1547069781,879594116,119398,61188,478572
67585,15411,9898,0.00108175,0.01,1126733,1525502,1041552435,152538078,668956330,1.03E+13,1194090513,1.08E-05,1.11E-02,7236.4351,111520701.3,1.72E+12,2652235,153664811,1043077937,22320,8385,68994
32462,15191,13139,0.00163948,0.27,808537,53896833,493130242,199594549,426518218,6.48E+12,692724791,0.00044266,2.72E-01,188802.3838,2868097012,4.36E+13,54705370,200403086,547027075,36464,69020,62002
28228,11045,15236,0.00041097,0.2,128145,33659647,311778260,168281620,430081808,4.75E+12,480059880,8.22E-05,2.00E-01,35350.14413,390442341.9,4.31E+12,33787792,168409765,345437907,18305,30814,9310
8790,21008,5266,0.00370564,0.13,684341,14382335,184660320,110628128,46288140,9.72E+11,295288448,0.000481733,1.34E-01,22298.5338,468447598.2,9.84E+12,15066676,111312469,199042655,5246,6484,20631
71474,69560,20116,0.01084252,0.03,53906672,41978567,4971731440,1399268960,1437770984,1.00E+14,6371000400,0.000325276,4.08E-02,467671.8195,32531251763,2.26E+15,95885239,1453175632,5013710007,1798061,425777,5826298
62685,8764,21359,0.00860544,0.3,4728119,56165045,549371340,187190276,1338888915,1.17E+13,736561616,0.002581632,3.09E-01,3456518.467,30292927848,2.66E+14,60893164,191918395,605536385,177777,356487,545355
57949,5272,7868,0.00082185,0.25,251103,10371988,305507128,41480096,455942732,2.40E+12,346987224,0.000205463,2.51E-01,93679.13357,493876392.2,2.60E+12,10623091,41731199,315879116,8206,30776,17656
131054,99310,12348,0.00082282,5.00E-04,10709064,613151,13014972740,1226279880,1618254792,1.61E+14,14241252620,4.11E-07,1.32E-03,665.766204,66117241.72,6.57E+12,11322215,1236988944,13015585891,448522,4571,980413
2914,11502,8793,0.00952101,0.07,319125,7080480,33516828,101137086,25622802,2.95E+11,134653914,0.000666471,7.95E-02,17076.84678,196417891.7,2.26E+12,7399605,101456211,40597308,4703,3388,16147
16321,5681,20462,0.00108175,0.25,100302,29062590,92719601,116244622,333960302,1.90E+12,208964223,0.000270438,2.51E-01,90315.38917,513081725.9,2.92E+12,29162892,116344924,121782191,15467,30216,14380
121477,76645,4221,0.00108175,0.2,10071912,64704944,9310604665,323518545,512754417,3.93E+13,9634123210,0.00021635,2.01E-01,110934.4181,8502568477,6.52E+14,74776856,333590457,9375309609,165724,174168,302937
52831,44990,2389,0.00952101,0.005,22630667,537523,2376866690,107481110,126213259,5.68E+12,2484347800,4.76E-05,1.45E-02,6008.388505,270317398.9,1.22E+13,23168190,130111777,2377404213,86739,10885,285933
31675,6269,42255,0.01084252,0.17,2153149,45035833,198570575,264896595,1338427125,8.39E+12,463467170,0.001843228,1.81E-01,2467026.888,15465791562,9.70E+13,47188982,267049744,243606408,134080,235241,485021
13665,51673,35578,0.00296184,0.001,2091471,1838479,706111545,1838421994,486173370,2.51E+13,2544533539,2.96E-06,3.96E-03,1439.967734,74407452.73,3.85E+12,3929950,1840513465,707950024,110533,5071,420901
94363,5230,18546,0.00082282,0.05,406121,4850452,493518490,96995580,1750056198,9.15E+12,590514070,4.11E-05,5.08E-02,71999.06204,376555094.5,1.97E+12,5256573,97401701,498368942,27563,29114,63263
8068,7164,27509,0.00056263,0.3,32525,59128652,57799152,197074476,221942612,1.59E+12,254873628,0.000168789,3.01E-01,37461.47154,268373982.1,1.92E+12,59161177,197107001,116927804,24973,25835,8501
28048,74855,22865,0.00041097,0.03,862884,51349575,2099533040,1711559575,641317520,4.80E+13,3811092615,1.23E-05,3.04E-02,7906.867836,591868591.9,4.43E+13,52212459,1712422459,2150882615,48293,61197,133965
39622,7533,18033,0.00860544,0.23,2568732,31246910,298472526,135842589,714503526,5.38E+12,434315115,0.001979251,2.39E-01,1414181.961,10653032714,8.03E+13,33815642,138411321,329719436,75367,128306,248510
129932,33956,3780,0.00952101,0.2,42007014,25671601,4411970992,128353680,491142960,1.67E+13,4540324672,0.001904202,2.10E-01,935235.4067,31756853471,1.08E+15,67678615,170360694,4437642593,494074,353994,1095505
74912,1334,3484,0.00160539,0.27,160485,1255295,99932608,4647656,260993408,3.48E+11,104580264,0.000433455,2.72E-01,113128.976,150914053.9,2.01E+11,1415780,4808141,101187903,3318,9640,5948
5281,11567,38852,0.00047003,0.13,28713,58422940,61085327,449401084,205177412,2.37E+12,510486411,6.11E-05,1.30E-01,12537.14007,145017099.1,1.68E+12,58451653,449429797,119508267,6993,9063,34358
33516,14747,19335,0.00108175,0.17,534712,48476577,494260452,285133245,648031860,9.56E+12,779393697,0.000183898,1.71E-01,119171.439,1757421211,2.59E+13,49011289,285667957,542737029,27566,86110,63813
114172,84698,4706,0.00031941,0.13,3088770,51822721,9670140056,398588788,537293432,4.55E+13,10068728844,4.15E-05,1.30E-01,22310.19636,1889629012,1.60E+14,54911491,401677558,9721962777,38351,93321,108783
51159,22716,2259,0.00160539,0.27,1865687,13857905,1162127844,51315444,115568181,2.63E+12,1213443288,0.000433455,2.72E-01,50093.64057,1137927139,2.59E+13,15723592,53181131,1175985749,6611,19250,23568
95780,10019,13673,0.00860544,0.2,8258001,27398640,959619820,136989787,1309599940,1.31E+13,1096609607,0.001721088,2.09E-01,2253936.742,22582192213,2.26E+14,35656641,145247788,987018460,276399,335815,686060
29145,26837,12010,2.48E-05,0.2,19422,64466532,782164365,322312370,350031450,9.39E+12,1104476735,4.97E-06,2.00E-01,1738.256181,46649581.12,1.25E+12,64485954,322331792,846630897,31862,4995,32500
19262,19661,44929,0.00041097,0.03,155648,26502292,378710182,883349069,865422398,1.70E+13,1262059251,1.23E-05,3.04E-02,10669.87929,209780496.7,4.13E+12,26657940,883504717,405212474,34451,14889,67751
116600,39982,10365,2.48E-05,0.13,115757,53874609,4661901200,414413430,1208559000,4.83E+13,5076314630,3.23E-06,1.30E-01,3901.107596,155974083.9,6.24E+12,53990366,414529187,4715775809,38206,13211,33881
43985,51149,5612,0.00019487,0.2,438430,57413097,2249788765,287048188,246843820,1.26E+13,2536836953,3.90E-05,2.00E-01,9620.491041,492078496.2,2.52E+13,57851527,287486618,2307201862,31485,23857,31085
5833,13106,13574,0.00078778,0.23,60230,40921165,76447298,177900844,79177142,1.04E+12,254348142,0.000181189,2.31E-01,14346.05885,188019447.3,2.46E+12,40981395,177961074,117368463,3561,8375,7691
42872,36656,45279,0.00108175,0.03,1700014,49793592,1571516032,1659747024,1941201288,7.12E+13,3231263056,3.25E-05,3.11E-02,62996.8348,2309211976,8.46E+13,51493606,1661447038,1621309624,143105,165789,461942
44532,42425,24016,0.00082282,0.01,1554564,10188931,1889270100,1018878800,1069480512,4.54E+13,2908148900,8.23E-06,1.08E-02,8799.899549,373335738.4,1.58E+13,11743495,1020433364,1899459031,67842,28841,225478
37478,44058,20620,0.00163948,0.05,2707214,45424658,1651205724,908475960,772796360,3.40E+13,2559681684,8.20E-05,5.16E-02,63349.20881,2791039442,1.23E+14,48131872,911183174,1696630382,100540,119852,331238
78377,82115,5569,4.64E-06,0.15,29862,68598327,6435927355,457298435,436481513,3.58E+13,6893225790,6.96E-07,1.50E-01,303.791133,24945808.89,2.05E+12,68628189,457328297,6504525682,6255,3571,8498
12771,2864,41620,0.00370564,0.05,135589,5961984,36576144,119199680,531529020,1.52E+12,155775824,0.000185282,5.37E-02,98482.75988,282054624.3,8.08E+11,6097573,119335269,42538128,12526,19361,35753
43277,34415,10719,2.09E-05,0.17,31099,62713614,1489377955,368894385,463886163,1.60E+13,1858272340,3.55E-06,1.70E-01,1646.610324,56668094.31,1.95E+12,62744713,368925484,1552091569,6385,5309,9520
74690,89120,1325,0.00952101,0.3,63375803,35445931,6656372800,118084000,98964250,8.82E+12,6774456800,0.002856303,3.10E-01,282671.8842,25191718317,2.25E+15,98821734,181459803,6691818731,137558,203002,447124
28925,32171,1179,0.02533638,0.25,23577756,9490568,930546175,37929609,34102575,1.10E+12,968475784,0.006334095,2.75E-01,216008.9498,6949223924,2.24E+14,33068324,61507365,940036743,40251,42091,143374
27798,99771,1086,0.00082185,0.15,2279420,16265520,2773434258,108351306,30188628,3.01E+12,2881785564,0.000123278,1.51E-01,3721.578588,371305617.3,3.71E+13,18544940,110630726,2789699778,5230,5436,14776
92588,76143,8287,0.00370564,0.01,26124739,6310421,7049928084,630997041,767276756,5.84E+13,7680925125,3.71E-05,1.37E-02,28432.51438,2164936943,1.65E+14,32435160,657121780,7056238505,512561,103475,1310437
19165,22550,14748,0.00015297,0.13,66110,43235277,432170750,332567400,282645420,6.37E+12,764738150,1.99E-05,1.30E-01,5620.715087,126747125.2,2.86E+12,43301387,332633510,475406027,6802,18287,11442
22793,33724,31752,0.02533638,0.05,19476525,53542218,768671132,1070804448,723723336,2.44E+13,1839475580,0.001266819,7.53E-02,916826.4728,30919055968,1.04E+15,73018743,1090280973,822213350,920814,277580,3252450
42203,12804,3583,0.00296184,0.03,1600566,1376601,540367212,45876732,151213349,1.94E+12,586243944,8.89E-05,3.30E-02,13436.09237,172035726.7,2.20E+12,2977167,47477298,541743813,9772,11066,32859
143064,27390,4220,0.00182521,0.17,7152354,19651828,3918522960,115585800,603730080,1.65E+13,4034108760,0.000310286,1.72E-01,187328.8105,5130936119,1.41E+14,26804182,122738154,3938174788,115780,117615,225935
127324,14202,12459,0.00108175,0.3,1956124,53085074,1808255448,176942718,1586329716,2.25E+13,1985198166,0.000324525,3.01E-01,514803.6511,7311241453,1.04E+14,55041198,178898842,1861340522,80885,261416,182014
28838,53414,5834,0.00019487,0.15,300174,46747082,1540352932,311617276,168240892,8.99E+12,1851970208,2.92E-05,1.50E-01,4917.765394,262677520.7,1.40E+13,47047256,311917450,1587100014,7140,24451,15121
13357,3737,49963,0.00041097,0.17,20517,31744729,49915109,186711731,667355791,2.49E+12,236626840,6.99E-05,1.70E-01,46624.7456,174236674.3,6.51E+11,31765246,186732248,81659838,14607,16756,17526
40002,981,44624,0.00056263,0.2,22081,8756289,39241962,43776144,1785049248,1.75E+12,83018106,0.000112526,2.01E-01,200864.4517,197048027.1,1.93E+11,8778370,43798225,47998251,15660,11449,23190
52768,11598,4469,0.00296184,0.23,1812791,11924070,612003264,51831462,235820192,2.74E+12,663834726,0.000681223,2.33E-01,160646.1858,1863174463,2.16E+13,13736861,53644253,623927334,14949,35701,44056
74291,80848,3239,0.00163948,0.1,9847228,26190280,6006278768,261866672,240628549,1.95E+13,6268145440,0.000163948,1.02E-01,39450.56935,3189499631,2.58E+14,36037508,271713900,6032469048,55070,61738,174479
31991,6296,36602,0.00047003,0.25,94679,57616614,201415336,230446192,1170934582,7.37E+12,431861528,0.000117508,2.50E-01,137593.5954,866289276.6,5.46E+12,57711293,230540871,259031950,23332,57248,40178
74523,35337,6319,0.00108175,0.01,2848742,2233157,2633419251,223294503,470910837,1.66E+13,2856713754,1.08E-05,1.11E-02,5094.077979,180009433.6,6.36E+12,5081899,226143245,2635652408,33713,13330,103948
23746,25972,7874,0.00296184,0.23,1826750,47039032,616731112,204503528,186976004,4.86E+12,821234640,0.000681223,2.33E-01,127372.3918,3308115759,8.59E+13,48865782,206330278,663770144,18345,38865,76768
74610,26810,14303,0.00296184,0.17,5924737,65191887,2000294100,383463430,1067146830,2.86E+13,2383757530,0.000503513,1.73E-01,537322.0884,14405605190,3.86E+14,71116624,389388167,2065485987,166760,250366,461229
65748,99094,10392,0.00160539,0.03,10459562,30896059,6515232312,1029784848,683253216,6.77E+13,7545017160,4.82E-05,3.16E-02,32906.63641,3260850229,3.23E+14,41355621,1040244410,6546128371,181245,112078,598997
67016,70511,14954,0.00491597,0.01,23230088,10544468,4725365176,1054421494,1002157264,7.07E+13,5779786670,4.92E-05,1.49E-02,49265.75045,3473777330,2.45E+14,33774556,1077651582,4735909644,574583,136721,1839683
18807,42546,7773,0.00296184,0.01,2370036,3307212,800162622,330710058,146186811,6.22E+12,1130872680,2.96E-05,1.30E-02,4329.819443,184216498,7.84E+12,5677248,333080094,803469834,24720,10980,99997
138930,71018,4653,0.00370564,0.13,36562006,42958652,9866530740,330446754,646441290,4.59E+13,10196977494,0.000481733,1.34E-01,311412.2312,22115873838,1.57E+15,79520658,367008760,9909489392,622152,312380,1263741
71338,23827,8242,0.00108175,0.15,1838785,29459093,1699770526,196382134,587967796,1.40E+13,1896152660,0.000162263,1.51E-01,95405.1245,2273217901,5.42E+13,31297878,198220919,1729229619,34787,85032,88034
90385,90948,10324,0.00082282,0.01,6763959,9390426,8220334980,938947152,933134740,8.49E+13,9159282132,8.23E-06,1.08E-02,7678.019268,698300496.4,6.35E+13,16154385,945711111,8229725406,172498,54106,439988
140665,33115,8686,0.00082282,0.2,3832931,57534165,4658121475,287636890,1221816190,4.05E+13,4945758365,0.000164564,2.01E-01,201066.9595,6658332364,2.21E+14,61367096,291469821,4715655640,132907,218311,252306
16385,32857,38118,0.00031941,0.05,171967,62624728,538361945,1252443126,624563430,2.05E+13,1790805071,1.60E-05,5.03E-02,9974.590259,327735112.1,1.08E+13,62796695,1252615093,600986673,28392,35309,64481
14432,16745,23501,0.00041097,0.15,99327,59033684,241663840,393524245,339166432,5.68E+12,635188085,6.16E-05,1.50E-01,20908.08428,350105871.3,5.86E+12,59133011,393623572,300697524,8894,20043,18593
130997,97478,5628,0.00034241,0.1,4372373,54866216,12769325566,548606184,737251116,7.19E+13,13317931750,3.42E-05,1.00E-01,25244.21546,2460755635,2.40E+14,59238589,552978557,12824191782,104790,112922,191580
97988,90894,1071,0.00491597,0.05,43784546,4870704,8906521272,97347474,104945148,9.54E+12,9003868746,0.000245799,5.49E-02,25795.35996,2344643448,2.13E+14,48655250,141132020,8911391976,123849,27391,279989
102500,24094,2280,0.00491597,0.13,12140976,7142411,2469635000,54934320,233700000,5.63E+12,2524569320,0.000639076,1.35E-01,149352.0846,3598489126,8.67E+13,19283387,67075296,2476777411,74390,62418,170715
47798,3110,28586,0.00056263,0.17,83652,15116762,148651780,88902460,1366353628,4.25E+12,237554240,9.56E-05,1.71E-01,130687.7621,406438940.1,1.26E+12,15200414,88986112,163768542,16108,29873,28600
23814,1018,48086,0.00952101,0.13,231013,6369073,24242652,48951548,1145120004,1.17E+12,73194200,0.001237731,1.40E-01,1417350.871,1442863187,1.47E+12,6600086,49182561,30611725,21208,71143,64140
53770,47912,3867,8.43E-05,0.15,217151,27796657,2576228240,185275704,207928590,9.96E+12,2761503944,1.26E-05,1.50E-01,2628.945128,125958019,6.04E+12,28013808,185492855,2604024897,13154,8598,17446
58322,77224,10797,0.00013363,0.05,601855,41691005,4503858128,833787528,629702634,4.86E+13,5337645656,6.68E-06,5.01E-02,4207.358149,324909025.7,2.51E+13,42292860,834389383,4545549133,23829,24498,64200
35524,41436,6917,0.00952101,0.2,14014718,57328830,1471972464,286612812,245719508,1.02E+13,1758585276,0.001904202,2.10E-01,467899.5786,19387886938,8.03E+14,71343548,300627530,1529301294,172621,143475,522649
43302,45284,14962,0.00296184,0.005,5807920,3387749,1960887768,677539208,647884524,2.93E+13,2638426976,1.48E-05,7.96E-03,9594.651493,434484198.2,1.97E+13,9195669,683347128,1964275517,140869,25726,457005
128494,15094,2567,0.00047003,0.23,911643,8914373,1939488436,38746298,329844098,4.98E+12,1978234734,0.000108107,2.30E-01,35658.42292,538228235.5,8.13E+12,9826016,39657941,1948402809,8453,31503,18971
84648,73824,13503,0.00370564,0.001,23157073,996878,6249053952,996845472,1143001944,8.44E+13,7245899424,3.71E-06,4.71E-03,4235.553724,312685518.1,2.31E+13,24153951,1020002545,6250050830,633444,23818,1783888
100244,35635,8152,0.01084252,0.2,38732330,58104573,3572194940,290496520,817189088,2.91E+13,3862691460,0.002168504,2.11E-01,1772077.806,63147992620,2.25E+15,96836903,329228850,3630299513,789260,681170,1925470
138303,18150,13971,0.00082185,0.07,2063103,17751906,2510199450,253573650,1932231213,3.51E+13,2763773100,5.75E-05,7.08E-02,111160.2956,2017559365,3.66E+13,19815009,255636753,2527951356,86732,137062,215168
147051,82507,5608,1.65E-05,0.1,200313,46271228,12132736857,462699256,824662008,6.80E+13,12595436113,1.65E-06,1.00E-01,1361.516975,112334681.1,9.27E+12,46471541,462899569,12179008085,27321,10300,29439
72704,18392,4955,0.00019487,0.25,260581,22786062,1337171968,91132360,360248320,6.63E+12,1428304328,4.87E-05,2.50E-01,17550.39753,322786911.4,5.94E+12,23046643,91392941,1359958030,11483,24885,11201
8779,36647,6390,0.00019487,0.15,62700,35131012,321724013,234174330,56097810,2.06E+12,555898343,2.92E-05,1.50E-01,1639.767035,60092542.54,2.20E+12,35193712,234237030,356855025,3545,3898,5373
103079,97058,3286,0.00160539,0.05,16061500,15947821,10004641582,318932588,338717594,3.29E+13,10323574170,8.03E-05,5.16E-02,27188.69191,2638880060,2.56E+14,32009321,334994088,10020589403,148559,68478,338057
122482,19786,12730,1.65E-05,0.17,40012,42820136,2423428852,251875780,1559195860,3.09E+13,2675304632,2.81E-06,1.70E-01,4376.19502,86587394.67,1.71E+12,42860148,251915792,2466248988,23186,7018,25289
108745,75656,5691,0.00034241,0.01,2817126,4306203,8227211720,430558296,618867795,4.68E+13,8657770016,3.42E-06,1.03E-02,2119.065217,160319998,1.21E+13,7123329,433375422,8231517923,44821,14394,117230
112565,11985,8360,0.00019487,0.15,262921,15030495,1349091525,100194600,941043400,1.13E+13,1449286125,2.92E-05,1.50E-01,27507.1691,329673421.7,3.95E+12,15293416,100457521,1364122020,13501,27291,26675
21168,56690,12862,0.00047003,0.03,564060,21875878,1200013920,729146780,272262816,1.54E+13,1929160700,1.41E-05,3.05E-02,3839.150742,217641455.6,1.23E+13,22439938,729710840,1221889798,18606,18301,49545
82934,89137,21601,0.00078778,0.001,5823727,1925541,7392487958,1925448337,1791457334,1.60E+14,9317936295,7.88E-07,1.79E-03,1411.274259,125796753.6,1.12E+13,7749268,1931272064,7394413499,269349,11231,765326
130037,81420,4458,2.09E-05,0.13,221070,47194872,10587612540,362970360,579704946,4.72E+13,10950582900,2.71E-06,1.30E-01,1573.551105,128118531,1.04E+13,47415942,363191430,10634807412,25416,21363,23193
94620,16968,5258,0.00034241,0.17,549754,15167798,1605512160,89217744,497511960,8.44E+12,1694729904,5.82E-05,1.70E-01,28960.02194,491393652.2,8.34E+12,15717552,89767498,1620679958,11853,32546,27107
122207,14899,5845,0.00182521,0.27,3323317,23513390,1820762093,87084655,714299915,1.06E+13,1907846748,0.000492807,2.72E-01,352011.7839,5244623569,7.81E+13,26836707,90407972,1844275483,62042,131448,137679
149431,19117,5722,0.00370564,0.01,10586263,1093938,2856672427,109387474,855044182,1.63E+13,2966059901,3.71E-05,1.37E-02,31684.85923,605719453.8,1.16E+13,11680201,119973737,2857766365,226500,41140,437599
45204,27931,20154,0.00082185,0.03,1037685,16887692,1262592924,562921374,911041416,2.54E+13,1825514298,2.47E-05,3.08E-02,22462.18163,627391195.2,1.75E+13,17925377,563959059,1279480616,42801,49066,130613
89262,57918,2855,0.00078778,0.1,4072797,16539698,5169876516,165355890,254843010,1.48E+13,5335232406,7.88E-05,1.01E-01,20076.02264,1162763079,6.74E+13,20612495,169428687,5186416214,26500,43624,74347
104718,80904,9719,0.00047003,0.005,3982197,3931777,8472105072,786305976,1017754242,8.23E+13,9258411048,2.35E-06,5.47E-03,2391.875132,193512265.7,1.57E+13,7913974,790288173,8476036849,102941,15897,278293
19520,28939,5171,0.00013363,0.15,75487,22446812,564889280,149643569,100937920,2.92E+12,714532849,2.00E-05,1.50E-01,2023.250137,58550835.73,1.69E+12,22522299,149719056,587336092,3042,3942,4895
43224,52105,38250,0.00163948,0.005,3692533,9965391,2252186520,1993016250,1653318000,8.61E+13,4245202770,8.20E-06,6.64E-03,13552.90897,706174322,3.68E+13,13657924,1996708783,2262151911,223202,49932,778299
94987,12224,14802,0.00078778,0.13,914710,23522693,1161121088,180939648,1405997574,1.72E+13,1342060736,0.000102411,1.31E-01,143990.1799,1760135960,2.15E+13,24437403,181854358,1184643781,39403,113319,96480
20831,8682,41118,0.00013363,0.13,24169,46412372,180854742,356986476,856529058,7.44E+12,537841218,1.74E-05,1.30E-01,14879.53714,129184141.5,1.12E+12,46436541,357010645,227267114,22834,19098,25260
53738,26467,4506,0.00182521,0.27,2595988,32206345,1422283646,119260302,242143428,6.41E+12,1541543948,0.000492807,2.72E-01,119329.9037,3158304561,8.36E+13,34802333,121856290,1454489991,28603,52861,63169
62935,61032,3657,8.43E-05,0.1,323765,22324791,3841048920,223194024,230153295,1.40E+13,4064242944,8.43E-06,1.00E-01,1939.962124,118399768.3,7.23E+12,22648556,223517789,3863373711,5809,8840,13833
128013,44114,3058,0.00952101,0.23,53767513,31027824,5647165482,134900612,391463754,1.73E+13,5782066094,0.002189832,2.40E-01,857239.9728,37816284160,1.67E+15,84795337,188668125,5678193306,484021,375175,1085258
59734,36977,34447,0.00078778,0.001,1740081,1273791,2208784118,1273746719,2057657098,7.61E+13,3482530837,7.88E-07,1.79E-03,1620.981109,59939018.46,2.22E+12,3013872,1275486800,2210057909,101124,4026,348695
17742,94537,13252,0.00082487,0.05,1383598,62644673,1677275454,1252804324,235116984,2.22E+13,2930079778,4.12E-05,5.08E-02,9697.04733,916729763.4,8.67E+13,64028271,1254187922,1739920127,55433,32006,135480
142896,21726,14369,0.00047003,0.05,1459268,15609663,3104558496,312180894,2053272624,4.46E+13,3416739390,2.35E-05,5.05E-02,48254.98657,1048387838,2.28E+13,17068931,313640162,3120168159,63778,81302,165848
108531,26544,12907,0.00082185,0.2,2367652,68524091,2880846864,342603408,1400809617,3.72E+13,3223450272,0.00016437,2.01E-01,230251.0767,6111784581,1.62E+14,70891743,344971060,2949370955,102581,214764,211002
94993,26394,10190,0.00019487,0.05,488607,13449176,2507245242,268954860,967978670,2.55E+13,2776200102,9.74E-06,5.02E-02,9431.500171,248935015.5,6.57E+12,13937783,269443467,2520694418,21626,21101,48352
30683,7848,9094,0.00019487,0.27,46930,19272087,240800184,71369712,279031202,2.19E+12,312169896,5.26E-05,2.70E-01,14681.19879,115218048.1,9.04E+11,19319017,71416642,260072271,8674,11681,4893
87110,32352,7509,0.00082487,0.17,2324706,41300557,2818182720,242931168,654108990,2.12E+13,3061113888,0.000140228,1.71E-01,91724.33004,2967465525,9.60E+13,43625263,245255874,2859483277,54561,111633,109152
51052,10294,38208,0.00082487,0.07,433534,27534437,525529288,393313152,1950594816,2.01E+13,918842440,5.77E-05,7.08E-02,112629.1002,1159403958,1.19E+13,27967971,393746686,553063725,45112,88880,113017
79009,20012,10703,0.00015297,0.3,241869,64258202,1581128108,214188436,845633327,1.69E+13,1795316544,4.59E-05,3.00E-01,38806.95901,776604863.7,1.55E+13,64500071,214430305,1645386310,22334,58486,25375
7046,8924,21673,0.00860544,0.07,541209,13540082,62878504,193409852,152707958,1.36E+12,256288356,0.000602381,7.86E-02,91988.34191,820903963.2,7.33E+12,14081291,193951061,76418586,14497,20044,64627
28442,20562,34164,0.00031941,0.05,186808,35125405,584824404,702480168,971692488,2.00E+13,1287304572,1.60E-05,5.03E-02,15518.41488,319089646.8,6.56E+12,35312213,702666976,619949809,33078,29548,43985
136127,63170,15066,0.00082487,5.00E-04,7093277,475885,8599142590,951719220,2050889382,1.30E+14,9550861810,4.12E-07,1.32E-03,845.8585623,53432885.38,3.38E+12,7569162,958812497,8599618475,369239,3449,832157
49733,38857,30592,0.00160539,0.001,3102422,1188730,1932475181,1188713344,1521431936,5.91E+13,3121188525,1.61E-06,2.61E-03,2442.491616,94907896.71,3.69E+12,4291152,1191815766,1933663911,152765,7354,531581
69415,51475,23755,0.00952101,0.01,34020846,12228430,3573137125,1222788625,1648953325,8.49E+13,4795925750,9.52E-05,1.95E-02,156997.011,8081421140,4.16E+14,46249276,1256809471,3585365555,1286378,241296,4319073
142708,11407,11904,0.00031941,0.25,519997,33950284,1627870156,135788928,1698796032,1.94E+13,1763659084,7.99E-05,2.50E-01,135653.1101,1547395027,1.77E+13,34470281,136308925,1661820440,33190,117107,64221
51481,96219,1803,0.00082487,0.07,4086061,12147185,4953450339,173482857,92820243,8.93E+12,5126933196,5.77E-05,7.08E-02,5359.524369,515688075.3,4.96E+13,16233246,177568918,4965597524,12730,13930,42970
78572,9001,15474,0.00082487,0.27,583413,37610254,707226572,139281474,1215823128,1.09E+13,846508046,0.000222715,2.71E-01,270781.9264,2437308119,2.19E+13,38193667,139864887,744836826,32242,127132,63242
18541,84938,8146,0.02533638,0.01,39902020,6919739,1574835458,691904948,151034986,1.28E+13,2266740406,0.000253364,3.53E-02,38266.79799,3250305287,2.76E+14,46821759,731806968,1581755197,442788,34302,1689405
77894,21232,18533,0.00031941,0.03,528285,11805957,1653845408,393492656,1443609502,3.07E+13,2047338064,9.58E-06,3.03E-02,13833.09933,293704365,6.24E+12,12334242,394020941,1665651365,31339,25028,77406
84371,56043,3237,0.00082487,0.17,3900416,30847285,4728403953,181411191,273108927,1.53E+13,4909815144,0.000140228,1.71E-01,38297.4913,2146306305,1.20E+14,34747701,185311607,4759251238,42960,58925,78255
18919,5369,38328,0.00018467,0.13,18758,26752322,101576111,205783032,725127432,3.89E+12,307359143,2.40E-05,1.30E-01,17408.20677,93464662.16,5.02E+11,26771080,205801790,128328433,15970,12545,17058
32378,42098,3830,0.00015297,0.27,208509,43537357,1363049044,161235340,124007740,5.22E+12,1524284384,4.13E-05,2.70E-01,5121.755277,215615653.6,9.08E+12,43745866,161443849,1406586401,3763,11394,7860
35895,4748,11288,0.00182521,0.15,311112,8040481,170429460,53595424,405182760,1.92E+12,224024884,0.000273782,1.52E-01,110931.5438,526702970,2.50E+12,8351593,53906536,178469941,8924,30909,23729
148838,6317,11146,0.00160539,0.15,1509526,10562426,940209646,70409282,1658948348,1.05E+13,1010618928,0.000240808,1.52E-01,399488.8633,2523571149,1.59E+13,12071952,71918808,950772072,47697,144953,128645
68204,96895,3091,1.65E-05,0.23,109109,68892016,6608626580,299502445,210818564,2.04E+13,6908129025,3.80E-06,2.30E-01,800.5413331,77568452.47,7.52E+12,69001125,299611554,6677518596,4938,7097,7150
29075,18260,15175,0.00082282,0.17,436866,47109404,530909500,277095500,441213125,8.06E+12,808005000,0.000139879,1.71E-01,61716.6272,1126945613,2.06E+13,47546270,277532366,578018904,34576,55850,42597
113859,37739,2201,0.00108175,0.2,4648226,16613321,4296924801,83063539,250603659,9.46E+12,4379988340,0.00021635,2.01E-01,54218.10162,2046136937,7.72E+13,21261547,87711765,4313538122,32563,50078,71111
95770,67892,894,0.00056263,0.13,3658263,7895872,6502016840,60695448,85618380,5.81E+12,6562712288,7.31E-05,1.31E-01,6262.290988,425159459.8,2.89E+13,11554135,64353711,6509912712,8343,13589,25901
124915,91892,7565,0.00056263,0.005,6458343,3476285,11478689180,695162980,944981975,8.68E+13,12173852160,2.81E-06,5.56E-03,2658.376043,244283491.3,2.25E+13,9934628,701621323,11482165465,165975,20374,369802
106020,59554,2520,0.00056263,0.27,3552434,40522244,6313915080,150076080,267170400,1.59E+13,6463991160,0.00015191,2.71E-01,40585.88218,2417051627,1.44E+14,44074678,153628514,6354437324,36821,54572,63534
107778,66480,12559,0.00034241,0.05,2453429,41746687,7165081440,834922320,1353583902,9.00E+13,8000003760,1.71E-05,5.03E-02,23174.03319,1540609727,1.02E+14,44200116,837375749,7206828127,95310,121539,241289
64485,38227,14351,0.00082185,0.05,2025966,27432188,2465068095,548595677,925424235,3.54E+13,3013663772,4.11E-05,5.08E-02,38027.99538,1453696179,5.56E+13,29458154,550621643,2492500283,58378,97947,178492
61466,7681,18641,0.00491597,0.17,2321002,24341476,472120346,143181521,1145787706,8.80E+12,615301867,0.000835715,1.75E-01,957551.8581,7354955822,5.65E+13,26662478,145502523,496461822,73656,176544,240342
60940,91826,10362,0.00860544,0.001,48156018,951548,5595876440,951501012,631460280,5.80E+13,6547377452,8.61E-06,9.61E-03,5433.993552,498981891.9,4.58E+13,49107566,999657030,5596827988,766855,28478,2651189
10038,78818,13331,0.01084252,0.005,8579132,5253717,791175084,1050722758,133816578,1.05E+13,1841897842,5.42E-05,1.58E-02,7254.544616,571788697.6,4.51E+13,13832849,1059301890,796428801,155216,19527,607537
50748,18885,40064,0.00491597,0.05,4711420,37831557,958375980,756608640,2033167872,3.84E+13,1714984620,0.000245799,5.49E-02,499749.6132,9437771445,1.78E+14,42542977,761320060,996207537,301674,279082,1025339
53164,5448,23888,0.02533638,0.17,7339671,22128929,289637472,130141824,1269981632,6.92E+12,419779296,0.004307185,1.95E-01,5470045.328,29800806945,1.62E+14,29468600,137481495,311766401,269041,305291,915853
66376,69071,6541,8.43E-05,0.05,386443,22591672,4584656696,451793411,434165416,3.00E+13,5036450107,4.21E-06,5.01E-02,1829.790146,126385435.2,8.73E+12,22978115,452179854,4607248368,19948,10451,29629
101778,89470,6498,0.00047003,0.1,4280134,58141927,9106077660,581376060,661353444,5.92E+13,9687453720,4.70E-05,1.00E-01,31085.59593,2781228268,2.49E+14,62422061,585656194,9164219587,70135,127198,195293
116778,87515,4430,0.00041097,0.17,4200087,65916071,10219826670,387691450,517326540,4.53E+13,10607518120,6.99E-05,1.70E-01,36142.96698,3163051756,2.77E+14,70116158,391891537,10285742741,81129,95474,138906
99276,24662,14700,0.00163948,0.13,4014099,47133065,2448344712,362531400,1459357200,3.60E+13,2810876112,0.000213132,1.32E-01,311036.3025,7670777292,1.89E+14,51147164,366545499,2495477777,154550,222505,382245
77291,3698,16712,0.02533638,0.05,7242093,3090220,285822118,61800976,1291687192,4.78E+12,347623094,0.001266819,7.53E-02,1636333.877,6051162677,2.24E+13,10332313,69043069,288912338,195461,158371,650920
109458,88928,14145,2.48E-05,0.01,241692,12579474,9733881024,1257886560,1548283410,1.38E+14,10991767584,2.48E-07,1.00E-02,384.4387707,34187371,3.04E+12,12821166,1258128252,9746460498,39850,3036,57506
30002,45234,6709,0.00047003,0.23,637890,69803971,1357110468,303474906,201283418,9.10E+12,1660585374,0.000108107,2.30E-01,21760.12634,984297554.9,4.45E+13,70441861,304112796,1426914439,43267,27299,27990
33160,76884,4814,0.00182521,0.15,4653375,55526158,2549473440,370119576,159632240,1.23E+13,2919593016,0.000273782,1.52E-01,43704.35412,3360165562,2.58E+14,60179533,374772951,2604999598,34254,42191,123392
34294,31500,4916,0.00160539,0.07,1734270,10840339,1080261000,154854000,168589304,5.31E+12,1235115000,0.000112377,7.16E-02,18945.61079,596786740,1.88E+13,12574609,156588270,1091101339,12127,22804,48443
104687,68831,17307,0.00108175,0.03,7794819,35738155,7205710897,1191258117,1811817909,1.25E+14,8396969014,3.25E-05,3.11E-02,58798.02069,4047126562,2.79E+14,43532974,1199052936,7241449052,373264,220609,909922
107587,53799,3145,0.00108175,0.25,6261286,42301711,5788073013,169197855,338361115,1.82E+13,5957270868,0.000270438,2.51E-01,91505.53404,4922906226,2.65E+14,48562997,175459141,5830374724,72188,79405,135941
75009,26498,16496,0.01084252,0.01,21551351,4371284,1987588482,437111008,1237348464,3.28E+13,2424699490,0.000108425,2.08E-02,134159.7547,3554965179,9.42E+13,25922635,458662359,1991959766,580925,145648,1920077
111072,80551,12379,8.43E-05,0.03,754142,29914794,8946960672,997140829,1374960288,1.11E+14,9944101501,2.53E-06,3.01E-02,3476.86208,280064717.4,2.26E+13,30668936,997894971,8976875466,50375,29777,103630
74870,36072,27484,0.00082282,0.07,2222250,69401615,2700710640,991402848,2057727080,7.42E+13,3692113488,5.76E-05,7.08E-02,118519.7297,4275243690,1.54E+14,71623865,993625098,2770112255,136261,251642,385302
123079,89487,5142,0.00491597,0.15,54145161,69023104,11013970473,460142154,632872218,5.66E+13,11474112627,0.000737396,1.55E-01,466677.1256,41761535941,3.74E+15,123168265,514287315,11082993577,915382,501432,1908941
47933,76601,10278,0.00056263,0.005,2065877,3936721,3671715733,787305078,492655374,3.77E+13,4459020811,2.81E-06,5.56E-03,1385.913465,106162357.4,8.13E+12,6002598,789370955,3675652454,41818,9540,131046
26698,40091,6699,0.00034241,0.07,366502,18800739,1070349518,268569609,178849902,7.17E+12,1338919127,2.40E-05,7.03E-02,4286.799646,171862084.6,6.89E+12,19167241,268936111,1089150257,6925,11139,18262
21438,64521,24446,0.00013363,0.01,184842,15773406,1383201198,1577280366,524073348,3.38E+13,2960481564,1.34E-06,1.01E-02,700.3192149,45185296.07,2.92E+12,15958248,1577465208,1398974604,38282,3664,58203
11997,68920,18790,0.00056263,0.005,465228,6475064,826833240,1295006800,225423630,1.55E+13,2121840040,2.81E-06,5.56E-03,634.1504847,43705651.41,3.01E+12,6940292,1295472028,833308304,28937,3141,66304
33223,49856,17185,0.00860544,0.005,14254281,4284120,1656365888,856775360,570937255,2.85E+13,2513141248,4.30E-05,1.36E-02,24565.83146,1224754093,6.11E+13,18538401,871029641,1660650008,372784,62475,1286950
77801,96142,3666,0.00182521,0.15,13652736,52871746,7479943742,352456572,285218466,2.74E+13,7832400314,0.000273782,1.52E-01,78087.53945,7507492218,7.22E+14,66524482,366109308,7532815488,121408,103930,285563
115719,20583,6112,0.01084252,0.3,25826382,37745702,2381844177,125803296,707274528,1.46E+13,2507647473,0.003252756,3.11E-01,2300591.465,47353074116,9.75E+14,63572084,151629678,2419589879,444757,482829,1008617
42186,10950,14594,0.02533638,0.27,11704800,43152468,461936700,159804300,615662484,6.74E+12,621741000,0.006840823,2.95E-01,4211637.835,46117434288,5.05E+14,54857268,171509100,505089168,265798,321890,885146
32673,39568,49151,0.00031941,0.005,412947,9724260,1292805264,1944806768,1605910623,6.35E+13,3237612032,1.60E-06,5.32E-03,2564.71956,101480823.6,4.02E+12,10137207,1945219715,1302529524,62700,7110,153624
143714,22980,12572,1.65E-05,0.2,54526,57785245,3302547720,288904560,1806772408,4.15E+13,3591452280,3.30E-06,2.00E-01,5965.962491,137097818,3.15E+12,57839771,288959086,3360332965,43715,11312,39506
119630,45305,2454,0.01084252,0.25,58765872,27799424,5419837150,111178470,293572020,1.33E+13,5531015620,0.00271063,2.61E-01,795765.1246,36052138969,1.63E+15,86565296,169944342,5447636574,398561,347977,926049
93688,68661,1699,0.00491597,0.03,31623603,3500534,6432711768,116655039,159175912,1.09E+13,6549366807,0.000147479,3.49E-02,23475.12024,1611825231,1.11E+14,35124137,148278642,6436212302,132079,32200,340475
110718,29280,11136,0.00082487,0.15,2674171,48911206,3241823040,326062080,1232955648,3.61E+13,3567885120,0.000123731,1.51E-01,152554.2188,4466787527,1.31E+14,51585377,328736251,3290734246,83429,187367,208696
94680,42028,2534,0.00031941,0.3,1271037,31950724,3979211040,106498952,239919120,1.01E+13,4085709992,9.58E-05,3.00E-01,22989.76984,966214046.7,4.06E+13,33221761,107769989,4011161764,16486,40586,22779
15680,14140,18518,0.01084252,0.1,2404173,26186650,221715200,261844520,290362240,4.11E+12,483559720,0.001084252,1.11E-01,314825.8394,4451637370,6.30E+13,28590823,264248693,247901850,52143,59118,235629
86135,93982,1850,0.00163948,0.25,13271960,43475914,8095139570,173866700,159349750,1.50E+13,8269006270,0.00040987,2.52E-01,65312.68203,6138216483,5.77E+14,56747874,187138660,8138615484,57523,74614,148503
126581,9573,4946,0.00013363,0.23,161935,10891312,1211759913,47348058,626069626,5.99E+12,1259107971,3.07E-05,2.30E-01,19242.18735,184205459.5,1.76E+12,11053247,47509993,1222651225,8255,15433,13981
54009,46386,5420,2.48E-05,0.17,62206,42742862,2505261474,251412120,292728780,1.36E+13,2756673594,4.22E-06,1.70E-01,1235.637453,57316278.91,2.66E+12,42805068,251474326,2548004336,19541,4817,15804
137014,11631,9552,0.00160539,0.15,2558512,16666296,1593609834,111099312,1308757728,1.52E+13,1704709146,0.000240808,1.52E-01,315159.9853,3665625790,4.26E+13,19224808,113657824,1610276130,70902,155939,176344
63713,21323,23956,0.00182521,0.005,2479672,2554145,1358552299,510813788,1526308628,3.25E+13,1869366087,9.13E-06,6.83E-03,13929.16885,297011667.5,6.33E+12,5033817,513293460,1361106444,96170,22098,328902
131999,47960,2813,0.00491597,0.13,31122087,17541515,6330672040,134911480,371313187,1.78E+13,6465583520,0.000639076,1.35E-01,237297.3834,11380782509,5.46E+14,48663602,166033567,6348213555,297009,156862,601440
95301,80545,1698,0.00860544,0.17,66056619,23258728,7676019045,136765410,161821098,1.30E+13,7812784455,0.001462925,1.79E-01,236732.0974,19067586787,1.54E+15,89315347,202822029,7699277773,276263,178657,657668
129193,32001,2580,0.00160539,0.005,6637235,412842,4134305193,82562580,333317940,1.07E+13,4216867773,8.03E-06,6.61E-03,2675.526438,85619521.56,2.74E+12,7050077,89199815,4134718035,56737,7359,125325
91043,58971,20801,0.00019487,0.005,1046259,6133639,5368896753,1226655771,1893785443,1.12E+14,6595552524,9.74E-07,5.19E-03,1845.209846,108813869.9,6.42E+12,7179898,1227702030,5375030392,61731,10252,171419
68035,27306,9442,0.00163948,0.01,3045896,2578516,1857763710,257823252,642386470,1.75E+13,2115586962,1.64E-05,1.16E-02,10531.7977,287581268,7.85E+12,5624412,260869148,1860342226,48953,21264,159624
13954,33818,38054,0.00082185,0.005,387836,6434699,471896372,1286910172,531005516,1.80E+13,1758806544,4.11E-06,5.82E-03,2182.034417,73792039.9,2.50E+12,6822535,1287298008,478331071,40601,5194,100969
102345,57425,700,0.00082282,0.15,4835921,6030907,5877161625,40197500,71641500,4.11E+12,5917359125,0.000123423,1.51E-01,8842.208855,507763843.5,2.92E+13,10866828,45033421,5883192532,8759,12687,25350
72890,27850,27190,2.09E-05,0.03,42386,22717755,2029986500,757241500,1981879100,5.52E+13,2787228000,6.26E-07,3.00E-02,1241.449068,34574356.55,9.63E+11,22760141,757283886,2052704255,33305,3124,43600
21666,33248,5593,0.00952101,0.005,6858738,929873,720351168,185956064,121177938,4.03E+12,906307232,4.76E-05,1.45E-02,5768.681797,191797132.4,6.38E+12,7788611,192814802,721281041,54977,10647,197498
147234,74227,1712,0.00013363,0.2,1460409,25420363,10928738118,127076624,252064608,1.87E+13,11055814742,2.67E-05,2.00E-01,6736.678713,500043450.9,3.71E+13,26880772,128537033,10954158481,17746,32416,21034
56321,36599,7429,0.00082282,0.2,1696088,54381734,2061292279,271893971,418408709,1.53E+13,2333186250,0.000164564,2.01E-01,68855.01079,2520024540,9.22E+13,56077822,273590059,2115674013,42588,71123,72199
82840,10157,19741,0.00082185,0.05,691514,10025733,841405880,200509337,1635344440,1.66E+13,1041915217,4.11E-05,5.08E-02,67200.3914,682554375.5,6.93E+12,10717247,201200851,851431613,36722,50175,96264
96949,81327,14697,0.00160539,5.00E-04,12657865,597650,7884571323,1195262919,1424859453,1.16E+14,9079834242,8.03E-07,2.11E-03,1143.727559,93015931.16,7.56E+12,13255515,1207920784,7885168973,462071,5323,1175127
138792,62468,1854,0.00015297,0.27,1326282,31282505,8670058656,115815672,257320368,1.61E+13,8785874328,4.13E-05,2.70E-01,10627.82011,663898666.5,4.15E+13,32608787,117141954,8701341161,19989,36914,20434
60693,58579,16756,0.00182521,5.00E-04,6489279,490778,3555335247,981549724,1016971908,5.96E+13,4536884971,9.13E-07,2.33E-03,928.0936481,54366797.81,3.18E+12,6980057,988039003,3555826025,183805,3489,590830
17885,32715,8291,0.01084252,0.25,6344550,67818889,585107775,271240065,148284535,4.85E+12,856347840,0.00271063,2.61E-01,401944.5091,13149614615,4.30E+14,74163439,277584615,652926664,70504,91338,270277
44105,91489,3582,0.00015297,0.13,617263,42614526,4035122345,327713598,157984110,1.45E+13,4362835943,1.99E-05,1.30E-01,3141.68781,287429876,2.63E+13,43231789,328330861,4077736871,7769,14744,17186
95374,20504,8198,2.09E-05,0.17,40832,28578981,1955548496,168091792,781876052,1.60E+13,2123640288,3.55E-06,1.70E-01,2775.347234,56905719.69,1.17E+12,28619813,168132624,1984127477,16632,4380,16582
71664,10810,29819,8.43E-05,0.2,65301,64471618,774687840,322343390,2136948816,2.31E+13,1097031230,1.69E-05,2.00E-01,36024.68314,389426824.7,4.21E+12,64536919,322408691,839159458,33977,48612,50731
29238,38008,8068,0.00082282,0.05,914412,15333951,1111277904,306648544,235892184,8.97E+12,1417926448,4.11E-05,5.08E-02,9704.840342,368861571.7,1.40E+13,16248363,307562956,1126611855,18878,25322,50713
28673,37852,8958,0.00078778,0.07,855029,23738532,1085330396,339078216,256852734,9.72E+12,1424408612,5.51E-05,7.08E-02,14164.04128,536137290.4,2.03E+13,24593561,339933245,1109068928,22907,35243,46033
109992,20548,3259,0.00108175,0.05,2444972,3349236,2260115616,66965932,358463928,7.37E+12,2327081548,5.41E-05,5.11E-02,19388.41771,398393207,8.19E+12,5794208,69410904,2263464852,21074,25015,55835
42644,63792,14611,0.00082282,0.07,2238381,65248083,2720346048,932064912,623071484,3.97E+13,3652410960,5.76E-05,7.08E-02,35887.29749,2289322482,1.46E+14,67486464,934303293,2785594131,77926,90697,211381
70936,12075,11426,0.01084252,0.05,9287952,6899502,856552200,137968950,810514736,9.79E+12,994521150,0.000542126,6.08E-02,439401.1118,5305768425,6.41E+13,16187454,147256902,863451702,171191,114664,557143
68119,63842,3655,0.00160539,0.13,6981771,30341284,4348853198,233342510,248974945,1.59E+13,4582195708,0.000208701,1.32E-01,51961.2453,3317309823,2.12E+14,37323055,240324281,4379194482,43088,62735,139053
94279,87168,2025,0.00108175,0.13,8889986,22954618,8218111872,176515200,190914975,1.66E+13,8394627072,0.000140628,1.31E-01,26847.89565,2340277368,2.04E+14,31844604,185405186,8241066490,51892,44575,115508
48933,34598,25335,0.00013363,0.07,226243,61360965,1692983934,876540330,1239717555,4.29E+13,2569524264,9.35E-06,7.01E-02,11596.44198,401213699.7,1.39E+13,61587208,876766573,1754344899,51198,42092,51448
126403,24422,11234,0.00491597,5.00E-04,15176022,137190,3087014066,274356748,1420011302,3.47E+13,3361370814,2.46E-06,5.42E-03,3490.36648,85241730.18,2.08E+12,15313212,289532770,3087151256,520835,3897,1177499
82427,71610,25398,0.00160539,0.01,9476046,18187884,5902597470,1818750780,2093480946,1.50E+14,7721348250,1.61E-05,1.16E-02,33608.53376,2406707102,1.72E+14,27663930,1828226826,5920785354,485394,152433,1394670
42738,34811,33201,0.00108175,0.03,1609436,34674352,1487752518,1155760011,1418944338,4.94E+13,2643512529,3.25E-05,3.11E-02,46048.29113,1602987062,5.58E+13,36283788,1157369447,1522426870,97287,105966,312763
85711,12614,14683,0.00047003,0.25,508191,46305808,1081158554,185211362,1258494613,1.59E+13,1266369916,0.000117508,2.50E-01,147882.5557,1865390558,2.35E+13,46813999,185719553,1127464362,38678,126349,57442
86472,8947,13177,0.00952101,0.05,7366241,5894871,773664984,117894619,1139441544,1.02E+13,891559603,0.000476051,5.95E-02,542431.7167,4853136570,4.34E+13,13261112,125260860,779559855,201178,137219,554713
54984,83377,6102,0.00034241,0.13,1569776,66141241,4584400968,508766454,335512368,2.80E+13,5093167422,4.45E-05,1.30E-01,14934.76269,1245215709,1.04E+14,67711017,510336230,4650542209,18890,56188,59275
63724,95476,2057,0.00952101,0.25,57927529,49106905,6084112624,196394132,131080268,1.25E+13,6280506756,0.002380253,2.60E-01,312004.1356,29788906851,2.84E+15,107034434,254321661,6133219529,187425,226254,611491
30439,9865,24460,0.00018467,0.27,55458,65158616,300280735,241297900,744537940,7.34E+12,541578635,4.99E-05,2.70E-01,37123.33177,366221667.9,3.61E+12,65214074,241353358,365439351,32205,35551,15937
146542,47400,14083,0.00015297,0.005,1062553,3337732,6946090800,667534200,2063750986,9.78E+13,7613625000,7.65E-07,5.15E-03,1578.459942,74819001.23,3.55E+12,4400285,668596753,6949428532,50181,7298,132569
100748,15470,15642,0.00952101,0.23,14839426,55657285,1558571560,241981740,1575900216,2.44E+13,1800553300,0.002189832,2.40E-01,3450957.195,53386307800,8.26E+14,70496711,256821166,1614228845,591891,507665,1420227
87925,32547,8362,0.00041097,0.25,1176079,68044245,2861694975,272158014,735228850,2.39E+13,3133852989,0.000102743,2.50E-01,75539.25012,2458575974,8.00E+13,69220324,273334093,2929739220,33706,118954,67705
86957,48971,13485,0.01084252,0.03,46171710,19811745,4258371247,660373935,1172615145,5.74E+13,4918745182,0.000325276,4.08E-02,381423.0949,18678670378,9.15E+14,65983455,706545645,4278182992,1366064,293261,3558672
130042,65776,1914,0.00047003,0.17,4020542,21404568,8553642592,125895264,248900388,1.64E+13,8679537856,7.99E-05,1.70E-01,19888.41039,1308180082,8.61E+13,25425110,129915806,8575047160,39894,49148,60861
5809,84755,1876,0.00952101,0.27,4688257,42949093,492341795,159000380,10897684,9.24E+11,651342175,0.002570673,2.80E-01,28014.37875,2374358671,2.01E+14,47637350,163688637,535290888,13383,18919,48068
77698,6250,17920,0.00082487,0.3,400582,33602895,485612500,112000000,1392348160,8.70E+12,597612500,0.000247461,3.01E-01,344551.868,2153449175,1.35E+13,34003477,112400582,519215395,32608,128476,56136
78663,19299,12625,0.00082185,0.005,1247707,1218330,1518117237,243649875,993120375,1.92E+13,1761767112,4.11E-06,5.82E-03,4080.979901,78758831.11,1.52E+12,2466037,244897582,1519335567,34050,6428,104029
2649,84683,24624,0.02533638,5.00E-04,5684914,1042655,224325267,2085234192,65228976,5.52E+12,2309559459,1.27E-05,2.58E-02,826.3330615,69976362.64,5.93E+12,6727569,2090919106,225367922,194873,3846,751545
52088,15022,17838,0.00041097,0.03,321591,8039611,782465936,267962436,929145744,1.40E+13,1050428372,1.23E-05,3.04E-02,11455.53079,172084983.6,2.59E+12,8361202,268284027,790505547,19794,14160,46509
66429,32330,13784,0.00047003,0.15,1009475,66849248,2147649570,445636720,915657336,2.96E+13,2593286290,7.05E-05,1.50E-01,64557.96265,2087158932,6.75E+13,67858723,446646195,2214498818,52609,123947,87775
117618,10808,992,0.00108175,0.13,1375257,1394957,1271215344,10721536,116677056,1.26E+12,1281936880,0.000140628,1.31E-01,16408.00269,177337693.1,1.92E+12,2770214,12096793,1272610301,3975,10514,10687
66514,4151,7842,0.00182521,0.25,504027,8140384,276099614,32552142,521602788,2.17E+12,308651756,0.000456303,2.52E-01,238008.6562,987973931.8,4.10E+12,8644411,33056169,284239998,10839,49672,25955
133625,11526,13352,0.00491597,0.25,7571851,38478673,1540161750,153895152,1784161000,2.06E+13,1694056902,0.001228993,2.55E-01,2192720.488,25273296342,2.91E+14,46050524,161467003,1578640423,329594,426845,713806
42436,8516,26991,0.00013363,0.3,48295,68962861,361384976,229855356,1145390076,9.75E+12,591240332,4.01E-05,3.00E-01,45917.54276,391033794.1,3.33E+12,69011156,229903651,430347837,38248,38728,31855
145430,80648,3878,0.00031941,0.13,3746282,40663288,11728638640,312752944,563977540,4.55E+13,12041391584,4.15E-05,1.30E-01,23418.20859,1888631686,1.52E+14,44409570,316499226,11769301928,65298,103733,111461
100514,35548,10445,0.00182521,0.15,6521707,55698280,3573071672,371298860,1049868730,3.73E+13,3944370532,0.000273782,1.52E-01,287434.6357,10217726430,3.63E+14,62219987,377820567,3628769952,192807,233497,431480
90087,69439,2220,0.00018467,0.2,1155221,30836400,6255551193,154154580,199993140,1.39E+13,6409705773,3.69E-05,2.00E-01,7386.546633,512914411.6,3.56E+13,31991621,155309801,6286387593,7314,22565,20728
138340,85490,3479,0.00082185,0.17,9719856,50563045,11826686600,297419710,481284860,4.11E+13,12124106310,0.000139715,1.71E-01,67242.47357,5748559066,4.91E+14,60282901,307139566,11877249645,116123,138005,252681
114462,63098,14564,0.00860544,0.005,62151931,4595101,7222323276,918959272,1667024568,1.05E+14,8141282548,4.30E-05,1.36E-02,71727.39949,4525855453,2.86E+14,66747032,981111203,7226918377,2535530,208736,5899552
86651,14625,2522,0.00013363,0.15,169353,5533435,1267270875,36884250,218533822,3.20E+12,1304155125,2.00E-05,1.50E-01,4380.401195,64063367.48,9.37E+11,5702788,37053603,1272804310,4139,4489,6872
136355,32014,3182,0.00491597,0.07,21459785,7131926,4365268970,101868548,433881610,1.39E+13,4467137518,0.000344118,7.49E-02,149306.4285,4779896001,1.53E+14,28591711,123328333,4372400896,230951,95040,481529
142780,54030,6777,0.00296184,0.17,22849102,62254817,7714403400,366161310,967620060,5.23E+13,8080564710,0.000503513,1.73E-01,487209.0857,26323906903,1.42E+15,85103919,389010412,7776658217,561045,378472,1159322
140006,72416,7045,0.00296184,0.1,30029388,51019636,10138674496,510170720,986342270,7.14E+13,10648845216,0.000296184,1.03E-01,292138.7989,21155523261,1.53E+15,81049024,540200108,10189694132,779620,327001,1537516
53373,79021,8062,0.00047003,0.01,1982397,6371423,4217587833,637067302,430293126,3.40E+13,4854655135,4.70E-06,1.05E-02,2022.50678,159820508.3,1.26E+13,8353820,639049699,4223959256,33177,14101,101943
135369,2777,4545,0.00296184,0.25,1113521,3156135,375919713,12621465,615252105,1.71E+12,388541178,0.00074046,2.53E-01,455569.5737,1265116706,3.51E+12,4269656,13734986,379075848,14666,57759,38667
62466,4438,32038,0.00108175,0.13,299930,18486882,277224108,142184644,2001285708,8.88E+12,419408752,0.000140628,1.31E-01,281435.8059,1249012107,5.54E+12,18786812,142484574,295710990,33532,84903,71225
95597,13088,12262,0.00056263,0.23,703966,36915078,1251173536,160485056,1172210414,1.53E+13,1411658592,0.000129405,2.31E-01,151689.7714,1985315728,2.60E+13,37619044,161189022,1288088614,36852,114984,63940
89687,14939,11773,0.00018467,0.15,247437,26384414,1339834093,175876847,1055885051,1.58E+13,1515710940,2.77E-05,1.50E-01,29248.54386,436943996.7,6.53E+12,26631851,176124284,1366218507,23401,33513,39994
55439,80579,1561,0.00182521,0.27,8153832,33966424,4467219181,125783819,86540279,6.97E+12,4593003000,0.000492807,2.72E-01,42647.62931,3436503322,2.77E+14,42120256,133937651,4501185605,20372,35777,67974
21709,41970,48083,0.00082185,0.005,748834,10090381,911126730,2018043510,1043833847,4.38E+13,2929170240,4.11E-06,5.82E-03,4289.374236,180025036.7,7.56E+12,10839215,2018792344,921217111,74650,12222,226811
75500,14319,14792,0.00108175,0.005,1169559,1059132,1081084500,211806648,1116796000,1.60E+13,1292891148,5.41E-06,6.08E-03,6040.470365,86493495.16,1.24E+12,2228691,212976207,1082143632,33900,6736,106392
65922,18166,10312,0.02533638,0.005,30342190,936689,1197539052,187327792,679787664,1.23E+13,1384866844,0.000126682,3.03E-02,86116.79287,1564397659,2.84E+13,31278879,217669982,1198475741,474498,76623,1600462
91142,12972,5935,0.00860544,0.25,10174449,19249592,1182294024,76988820,540927770,7.02E+12,1259282844,0.00215136,2.59E-01,1163730.367,15095910324,1.96E+14,29424041,87163269,1201543616,138703,185823,350765
119981,16464,15334,0.00491597,0.23,9711217,58070574,1975367184,252458976,1839788654,3.03E+13,2227826160,0.001130673,2.35E-01,2080199.541,34248405239,5.64E+14,67781791,262170193,2033437758,458290,531187,1035693
29019,10514,24642,0.00296184,0.27,903732,69957326,305105766,259085988,715086198,7.52E+12,564191754,0.000799697,2.73E-01,571852.1443,6012453445,6.32E+13,70861058,259989720,375063092,29169,114034,122470
114594,84115,1038,0.00034241,0.03,3300535,2619409,9639074310,87311370,118948572,1.00E+13,9726385680,1.03E-05,3.03E-02,1221.875416,102778050.6,8.65E+12,5919944,90611905,9641693719,11110,7428,26463
57831,40216,14699,0.00034241,0.07,796374,41381005,2325731496,591134984,850057869,3.42E+13,2916866480,2.40E-05,7.03E-02,20374.78204,819392234.7,3.30E+13,42177379,591931358,2367112501,42776,63241,91672
86561,24401,3775,0.00082487,0.03,1742347,2763954,2112174961,92113775,326767775,7.97E+12,2204288736,2.47E-05,3.08E-02,8086.228037,197312050.3,4.82E+12,4506301,93856122,2114938915,14531,16184,42780
124514,47794,16982,8.43E-05,0.07,501618,56817108,5951022116,811637708,2114496748,1.01E+14,6762659824,5.90E-06,7.01E-02,12476.16516,596285837.8,2.85E+13,57318726,812139326,6007839224,59125,69418,110454
31956,78638,13446,0.01084252,0.03,27247411,31722895,2512955928,1057366548,429680376,3.38E+13,3570322476,0.000325276,4.08E-02,139764.5421,10990804063,8.64E+14,58970306,1084613959,2544678823,523497,125374,1902415
52888,85865,4136,0.01084252,0.005,49238999,1775691,4541228120,355137640,218744768,1.88E+13,4896365760,5.42E-05,1.58E-02,11858.72261,1018249217,8.74E+13,51014690,404376639,4543003811,300885,26473,1038421
10843,14458,30625,0.02533638,0.1,3972218,44279242,156768094,442776250,332066875,4.80E+12,599544344,0.002533638,1.25E-01,841337.253,12164054004,1.76E+14,48251460,446748468,201047336,137454,109927,625031
93284,87084,5230,0.00034241,0.15,2781610,68321502,8123543856,455449320,487875320,4.25E+13,8578993176,5.14E-05,1.50E-01,25058.00825,2182151590,1.90E+14,71103112,458230930,8191865358,32152,63625,98853
87996,78232,2474,0.00015297,0.27,1053073,52257739,6884103072,193545968,217702104,1.70E+13,7077649040,4.13E-05,2.70E-01,8991.510529,703423851.7,5.50E+13,53310812,194599041,6936360811,26646,26724,20235
88707,27388,1625,0.00056263,0.03,1366926,1335779,2429507316,44505500,144148875,3.95E+12,2474012816,1.69E-05,3.06E-02,2433.074446,66637042.93,1.83E+12,2702705,45872426,2430843095,5868,4582,16029
143769,831,14638,0.00056263,0.3,67259,3651449,119472039,12164178,2104490622,1.75E+12,131636217,0.000168789,3.01E-01,355214.8676,295183555,2.46E+11,3718708,12231437,123123488,17163,19677,25445
109062,5263,9675,0.00047003,0.3,269817,15277662,573993306,50919525,1055174850,5.55E+12,624912831,0.000141009,3.00E-01,148789.1504,783077298.7,4.12E+12,15547479,51189342,589270968,14660,55539,28637
67532,50777,1204,0.00078778,0.13,2701416,7948751,3429072364,61135508,81308528,4.13E+12,3490207872,0.000102411,1.31E-01,8326.920184,422816026.2,2.15E+13,10650167,63836924,3437021115,5708,11829,21993
82627,55397,7160,0.00491597,0.05,22502235,19832457,4577287919,396642520,591609320,3.28E+13,4973930439,0.000245799,5.49E-02,145416.6834,8055648013,4.46E+14,42334692,419144755,4597120376,317837,133713,887223
13864,64032,10136,0.00018467,0.07,163951,45434242,887739648,649028352,140525504,9.00E+12,1536768000,1.29E-05,7.02E-02,1816.559138,116317914.7,7.45E+12,45598193,649192303,933173890,11387,17626,18828
9970,29796,19815,0.00047003,0.03,139639,17712984,297066120,590407740,197555550,5.89E+12,887473860,1.41E-05,3.05E-02,2785.711055,83003046.59,2.47E+12,17852623,590547379,314779104,12982,5670,24573
27251,27654,2344,0.00182521,0.2,1375507,12964342,753599154,64820976,63876344,1.77E+12,818420130,0.000365042,2.02E-01,23317.54837,644823482.5,1.78E+13,14339849,66196483,766563496,4463,10235,18039
16002,44523,28106,0.00082185,0.03,585545,37542424,712457046,1251363438,449752212,2.00E+13,1963820484,2.47E-05,3.08E-02,11088.86566,493709565.9,2.20E+13,38127969,1251948983,749999470,35088,34778,119048
63695,910,24354,0.00370564,0.27,214848,5985484,57962450,22162140,1551228030,1.41E+12,80124590,0.001000523,2.74E-01,1552039.012,1412355501,1.29E+12,6200332,22376988,63947934,19367,75294,39037
128795,85917,4489,0.00296184,0.1,32775248,38574923,11065680015,385681413,578160755,4.97E+13,11451361428,0.000296184,1.03E-01,171241.9651,14712595912,1.26E+15,71350171,418456661,11104254938,483585,224172,1004011
142828,3260,12642,0.00296184,0.23,1379176,9479640,465619280,41212920,1805631576,5.89E+12,506832200,0.000681223,2.33E-01,1230038.12,4009924272,1.31E+13,10858816,42592096,475098920,47136,158105,130826
98193,18707,13920,0.00047003,0.03,863416,7812474,1836896451,260401440,1366846560,2.56E+13,2097297891,1.41E-05,3.05E-02,19273.76666,360554352.9,6.75E+12,8675890,261264856,1844708925,34345,29290,88871
7317,7278,26334,0.00031941,0.3,17012,57504538,53253126,191658852,192685878,1.40E+12,244911978,9.58E-05,3.00E-01,18463.73889,134379091.6,9.78E+11,57521550,191675864,110757664,3034,7713,16455
86160,70311,3467,0.00182521,0.27,11057131,65827311,6057995760,243768237,298716720,2.10E+13,6301763997,0.000492807,2.72E-01,147209.601,10350454257,7.28E+14,76884442,254825368,6123823071,111350,135592,224017
7102,52391,13348,0.00082185,0.07,305834,48953765,372080882,699315068,94797496,4.97E+12,1071395950,5.75E-05,7.08E-02,5453.652546,285722310.5,1.50E+13,49259599,699620902,421034647,15396,10178,23662
117473,19911,12853,0.00047003,0.17,1099416,43509121,2339004903,255916083,1509880469,3.01E+13,2594920986,7.99E-05,1.70E-01,120647.1499,2402205401,4.78E+13,44608537,257015499,2382514024,52321,158593,106091
55589,12127,32021,2.48E-05,0.1,16738,38832786,674127803,388318667,1780015369,2.16E+13,1062446470,2.48E-06,1.00E-01,4419.778161,53598649.76,6.50E+11,38849524,388335405,712960589,31207,3854,37078
147025,66880,218,0.00370564,0.2,36438004,2922724,9833032000,14579840,32051450,2.14E+12,9847611840,0.000741128,2.04E-01,23754.22704,1588682704,1.06E+14,39360728,51017844,9835954724,29148,19855,58924
74391,16007,7946,0.00296184,0.27,3526935,34342785,1190776737,127191622,591110886,9.46E+12,1317968359,0.000799697,2.73E-01,472709.484,7566660710,1.21E+14,37869720,130718557,1225119522,58322,134031,154645
104630,9380,10427,0.02533638,0.15,24867579,14672396,981429400,97805260,1090977010,1.02E+13,1079234660,0.003800457,1.75E-01,4146211.214,38891461192,3.65E+14,39539975,122672839,996101796,565623,341557,627103
43142,34755,14831,0.00082282,0.03,1233770,15463876,1499400210,515451405,639839002,2.22E+13,2014851615,2.47E-05,3.08E-02,15794.16983,548926372.4,1.91E+13,16697646,516685175,1514864086,37399,38376,113368
54758,12540,25519,2.48E-05,0.13,17051,41604103,686665320,320008260,1397369402,1.75E+13,1006673580,3.23E-06,1.30E-01,4510.568693,56562531.41,7.09E+11,41621154,320025311,728269423,28312,4272,24339
57762,16292,4668,0.00041097,0.23,386753,17495317,941058504,76051056,269633016,4.39E+12,1017109560,9.45E-05,2.30E-01,25486.54853,415226848.7,6.77E+12,17882070,76437809,958553821,8408,24319,12585
20049,47038,2896,0.00082185,0.03,775081,4087193,943064862,136222048,58061904,2.73E+12,1079286910,2.47E-05,3.08E-02,1431.545274,67337026.6,3.17E+12,4862274,136997129,947152055,4304,3742,13675
147112,7137,7651,0.00082282,0.17,863924,9283280,1049938344,54605187,1125553912,8.03E+12,1104543531,0.000139879,1.71E-01,157441.8059,1123662169,8.02E+12,10147204,55469111,1059221624,22805,75155,56167
143793,94530,4731,0.00082487,0.13,11212368,58149374,13592752290,447221430,680284683,6.43E+13,14039973720,0.000107233,1.31E-01,72949.03544,6895872320,6.52E+14,69361742,458433798,13650901664,191913,162516,410875
10259,33362,19781,0.00056263,0.05,192576,32997732,342260758,659933722,202933279,6.77E+12,1002194480,2.81E-05,5.06E-02,5708.817538,190457570.7,6.35E+12,33190308,660126298,375258490,14593,11940,44255
37955,17548,11944,0.00082487,0.27,549420,56592894,666034340,209593312,453334520,7.96E+12,875627652,0.000222715,2.71E-01,100964.3523,1771722454,3.11E+13,57142314,210142732,722627234,34539,63792,40033
12794,30404,11169,0.00491597,0.005,1912423,1698029,388988776,339582276,142896186,4.34E+12,728571052,2.46E-05,9.92E-03,3512.366817,106790000.7,3.25E+12,3610452,341494699,390686805,28248,7137,115096
41716,1528,48939,0.00296184,0.15,188905,11223410,63742048,74778792,2041539324,3.12E+12,138520840,0.000444276,1.53E-01,907006.9247,1385906581,2.12E+12,11412315,74967697,74965458,28094,81853,65055
37196,29105,16987,0.00078778,0.005,852870,2472196,1082589580,494406635,631848452,1.84E+13,1576996215,3.94E-06,5.79E-03,2488.787868,72436170.89,2.11E+12,3325066,495259505,1085061776,27259,4593,88159
110126,57098,2512,0.00952101,0.23,59868882,32993807,6287974348,143430176,276636512,1.58E+13,6431404524,0.002189832,2.40E-01,605787.5693,34589258634,1.98E+15,92862689,203299058,6320968155,397091,322569,931350
8182,13786,8922,0.00296184,0.15,334103,18451299,112797052,122998692,72999804,1.01E+12,235795744,0.000444276,1.53E-01,32432.06092,447108391.9,6.16E+12,18785402,123332795,131248351,4657,8702,17757
18148,18364,19419,0.00056263,0.17,187516,60629063,333269872,356610516,352416012,6.47E+12,689880388,9.56E-05,1.71E-01,33707.56954,619005807.1,1.14E+13,60816579,356798032,393898935,34713,40646,25709
40195,24102,23034,0.00952101,0.1,9224040,55518603,968779890,555165468,925851630,2.23E+13,1523945358,0.000952101,1.10E-01,881504.2628,21246015741,5.12E+14,64742643,564389508,1024298493,334053,235711,1091196
16566,5053,30020,0.00082487,0.05,69054,7585169,83707998,151691060,497311320,2.51E+12,235399058,4.12E-05,5.08E-02,20510.85943,103641372.7,5.24E+11,7654223,151760114,91293167,9303,8108,18082
42216,29401,12661,0.00182521,0.07,2265511,26059241,1241192616,372246061,534496776,1.57E+13,1613438677,0.000127765,7.18E-02,68289.82024,2007789005,5.90E+13,28324752,374511572,1267251857,51489,73700,155722
50918,55054,16409,0.00082487,0.07,2312356,63239497,2803239572,903381086,835513462,4.60E+13,3706620658,5.77E-05,7.08E-02,48243.29926,2655986597,1.46E+14,65551853,905693442,2866479069,83356,132713,233533
7063,59916,4350,0.00370564,0.23,1568345,59946608,423186708,260634600,30724050,1.84E+12,683821308,0.000852297,2.34E-01,26186.02179,1568961681,9.40E+13,61514953,262202945,483133316,10452,13803,38368
39523,49021,420,0.00952101,0.3,18446961,6189340,1937456983,20588820,16599660,8.14E+11,1958045803,0.002856303,3.10E-01,47413.65866,2324264961,1.14E+14,24636301,39035781,1943646323,11588,15018,39582
59727,21613,3717,0.00018467,0.2,238399,16068081,1290879651,80335521,222005259,4.80E+12,1371215172,3.69E-05,2.00E-01,8199.542236,177216706.3,3.83E+12,16306480,80573920,1306947732,6688,11422,11286
76453,4896,13464,0.00296184,0.3,1108729,19777828,374313888,65919744,1029363192,5.04E+12,440233632,0.000888552,3.03E-01,914642.723,4478090772,2.19E+13,20886557,67028473,394091716,31597,132734,89365
117355,60103,17382,0.00108175,0.01,7630172,10447266,7053387565,1044710346,2039864610,1.23E+14,8098097911,1.08E-05,1.11E-02,22066.23542,1326246947,7.97E+13,18077438,1052340518,7063834831,402044,99940,910000
22975,2381,40471,0.00056263,0.2,30779,19273426,54703475,96361451,929821225,2.21E+12,151064926,0.000112526,2.01E-01,104629.0632,249121799.4,5.93E+11,19304205,96392230,73976901,12276,16051,18168
46426,68796,19586,0.00163948,0.005,5236474,6737523,3193923096,1347438456,909299636,6.26E+13,4541361552,8.20E-06,6.64E-03,7453.892836,512798011.6,3.53E+13,11973997,1352674930,3200660619,171388,38281,550648
110231,10373,2591,0.00108175,0.23,1237009,6183070,1143426163,26876443,285608521,2.96E+12,1170302606,0.000248803,2.31E-01,71060.11405,737106563,7.65E+12,7420079,28113452,1149609233,9199,30265,24880
77644,42191,6829,0.00082185,0.1,2692352,28816240,3275878004,288122339,530230876,2.24E+13,3564000343,8.22E-05,1.01E-01,43577.02454,1838558243,7.76E+13,31508592,290814691,3304694244,32064,79089,107365
46157,10736,40629,0.00108175,0.03,536103,13087097,495541552,436192944,1875312753,2.01E+13,931734496,3.25E-05,3.11E-02,60858.58712,653377791.3,7.02E+12,13623200,436729047,508628649,46660,48013,137162
78246,20255,7759,0.00860544,0.27,13638659,42434269,1584872730,157158545,607110714,1.23E+13,1742031275,0.002323469,2.79E-01,1410602.802,28571759757,5.79E+14,56072928,170797204,1627306999,200484,295477,560216
29621,57362,22002,0.00491597,0.001,8353081,1262109,1699119802,1262078724,651721242,3.74E+13,2961198526,4.92E-06,5.92E-03,3203.842074,183778789.1,1.05E+13,9615190,1270431805,1700381911,280187,13209,962310
68600,7338,28713,0.00108175,0.3,544610,63218078,503386800,210695994,1969711800,1.45E+13,714082794,0.000324525,3.01E-01,639220.7219,4690601657,3.44E+13,63762688,211240604,566604878,65269,213241,102812
75371,35441,10205,0.01084252,0.07,28963295,25317751,2671223611,361675405,769161055,2.73E+13,3032899016,0.000758976,8.08E-02,583775.0885,20689572913,7.33E+14,54281046,390638700,2696541362,498544,257818,1560070
33699,35145,10559,0.00034241,0.17,405551,63091417,1184351355,371096055,355827741,1.25E+13,1555447410,5.82E-05,1.70E-01,20712.62606,727945242.7,2.56E+13,63496968,371501606,1247442772,10563,45367,29538
110825,21706,709,0.00491597,0.15,11826031,2309565,2405567450,15389554,78574925,1.71E+12,2420957004,0.000737396,1.55E-01,57940.79611,1257662920,2.73E+13,14135596,27215585,2407877015,23694,19994,52608
10160,10643,36369,0.01084252,0.13,1172463,50321986,108132880,387075267,369509040,3.93E+12,495208147,0.001409528,1.41E-01,520833.1903,5543227645,5.90E+13,51494449,388247730,158454866,47179,63426,221102
71007,30439,12782,0.00491597,0.03,10625341,11672683,2161382073,389071298,907611474,2.76E+13,2550453371,0.000147479,3.49E-02,133853.7233,4074373485,1.24E+14,22298024,399696639,2173054756,227870,123118,720200
70841,95545,4315,0.00018467,0.13,1249953,53608194,6768503345,412276675,305678915,2.92E+13,7180780020,2.40E-05,1.30E-01,7338.46428,701153569.7,6.70E+13,54858147,413526628,6822111539,12798,33986,36401
18458,7585,7211,0.00296184,0.13,414729,7111664,140003930,54695435,133100638,1.01E+12,194699365,0.000385039,1.33E-01,51248.96318,388723385.7,2.95E+12,7526393,55110164,147115594,4401,14536,16865
105512,17486,14266,0.00034241,0.25,631755,62369043,1844982832,249455276,1505234192,2.63E+13,2094438108,8.56E-05,2.50E-01,128851.8099,2253102748,3.94E+13,63000798,250087031,1907351875,46866,155289,74314
41773,25567,33592,0.00491597,0.005,5250507,4294467,1068010291,858846664,1403238616,3.59E+13,1926856955,2.46E-05,9.92E-03,34491.3947,881841488.2,2.25E+13,9544974,864097171,1072304758,270026,54589,921031
89709,77798,10540,0.00860544,0.005,60059627,4100339,6979180782,819990920,945532860,7.36E+13,7799171702,4.30E-05,1.36E-02,40683.63147,3165105161,2.46E+14,64159966,880050547,6983281121,1428584,129761,3610026
41096,24657,10578,8.43E-05,0.2,85416,52171098,1013304072,260821746,434713488,1.07E+13,1274125818,1.69E-05,2.00E-01,7328.399981,180696358.3,4.46E+12,52256514,260907162,1065475170,17431,23277,11077
88998,25196,4008,0.00047003,0.15,1054009,15149256,2242393608,100985568,356703984,8.99E+12,2343379176,7.05E-05,1.50E-01,25149.23604,633660151.3,1.60E+13,16203265,102039577,2257542864,12730,37942,29246
99054,52000,7063,0.00860544,0.1,44325446,36727967,5150808000,367276000,699618402,3.64E+13,5518084000,0.000860544,1.09E-01,602052.4181,31306725743,1.63E+15,81053413,411601446,5187535967,773575,364288,1878474
13862,37279,6454,0.02533638,0.2,13093716,48124760,516761498,240598666,89465348,3.34E+12,757360164,0.005067276,2.25E-01,453345.6108,16900271023,6.30E+14,61218476,253692382,564886258,110954,106123,426750
69350,66165,24872,0.01084252,0.005,49752332,8228563,4588542750,1645655880,1724873200,1.14E+14,6234198630,5.42E-05,1.58E-02,93509.86084,6187079943,4.09E+14,57980895,1695408212,4596771313,1990662,224541,6599776
71370,29843,4520,0.00952101,0.1,20279199,13490858,2129894910,134890360,322592400,9.63E+12,2264785270,0.000952101,1.10E-01,307140.5466,9165995333,2.74E+14,33770057,155169559,2143385768,162903,109000,491188
90282,18060,8953,0.00082185,0.23,1340051,37192600,1630492920,161691180,808294746,1.46E+13,1792184100,0.000189026,2.31E-01,152788.3185,2759357032,4.98E+13,38532651,163031231,1667685520,35571,111553,80555
124279,58082,2980,0.00182521,0.13,13175139,22507337,7218372878,173084360,370351420,2.15E+13,7391457238,0.000237277,1.32E-01,87875.98499,5104012960,2.97E+14,35682476,186259499,7240880215,140587,101269,284444
39334,25794,6628,0.00860544,0.23,8731065,39326111,1014581196,170962632,260705752,6.72E+12,1185543828,0.001979251,2.39E-01,516002.1725,13309760037,3.43E+14,48057176,179693697,1053907307,104661,107602,304971
7128,53948,5382,0.00370564,0.03,1425149,8712135,384541344,290348136,38362896,2.07E+12,674889480,0.000111169,3.37E-02,4264.772458,230075944.6,1.24E+13,10137284,291773285,393253479,11726,5368,44215
110918,77937,287,0.00370564,0.3,32034001,6729845,8644616166,22367919,31833466,2.48E+12,8666984085,0.001111692,3.04E-01,35389.00948,2758113232,2.16E+14,38763846,54401920,8651346011,25870,28751,62586
69289,39490,997,0.00860544,0.01,23546945,394054,2736222610,39371530,69081133,2.73E+12,2775594140,8.61E-05,1.86E-02,5944.735452,234757603,9.28E+12,23940999,62918475,2736616664,39731,7777,124728
88522,83673,11253,0.00031941,0.005,2365859,4708172,7406901306,941572269,996138066,8.33E+13,8348473575,1.60E-06,5.32E-03,1590.882298,133113894.5,1.11E+13,7074031,943938128,7411609478,65857,12608,187738
22891,26710,6186,0.00182521,0.2,1116029,33050967,611418610,165228060,141603726,3.78E+12,776646670,0.000365042,2.02E-01,51691.30735,1380674819,3.69E+13,34166996,166344089,644469577,10047,23093,39382
114694,60913,2437,0.00952101,0.3,66518534,44551133,6986355622,148444981,279509278,1.70E+13,7134800603,0.002856303,3.10E-01,798363.1893,48630696949,2.96E+15,111069667,214963515,7030906755,460694,442399,1063824
52755,19228,29793,0.00370564,0.005,3759071,2864446,1014373140,572859804,1571729715,3.02E+13,1587232944,1.85E-05,8.71E-03,29121.32251,559944789.1,1.08E+13,6623517,576618875,1017237586,179294,35975,611447
56308,63527,3129,2.09E-05,0.25,74690,49705772,3577078316,198775983,176187732,1.12E+13,3775854299,5.22E-06,2.50E-01,919.699961,58425779.42,3.71E+12,49780462,198850673,3626784088,3335,4850,5526
33450,68388,6257,2.48E-05,0.1,56802,42795102,2287578600,427903716,209296650,1.43E+13,2715482316,2.48E-06,1.00E-01,519.683582,35540120.8,2.43E+12,42851904,427960518,2330373702,5734,3603,21352
103856,3453,7023,0.00018467,0.25,66239,6064228,358614768,24250419,729380688,2.52E+12,382865187,4.62E-05,2.50E-01,33673.68291,116275227.1,4.02E+11,6130467,24316658,364678996,7371,9709,11182
62116,12894,13857,0.00370564,0.13,2968196,23230029,800923704,178672158,860741412,1.11E+13,979595862,0.000481733,1.34E-01,414647.7148,5346467634,6.90E+13,26198225,181640354,824153733,73969,133828,227318
41358,4737,34011,0.02533638,0.2,4964527,32227261,195912846,161110107,1406626938,6.66E+12,357022953,0.005067276,2.25E-01,7127766.924,33764231918,1.60E+14,37191788,166074634,228140107,251656,330888,880993
109665,6151,15353,0.00034241,0.23,230997,21723744,674549415,94436303,1683686745,1.04E+13,768985718,7.88E-05,2.30E-01,132597.571,815607659.4,5.02E+12,21954741,94667300,696273159,24394,61576,41917
11952,74935,8091,0.00952101,0.005,8527475,3031693,895623120,606299085,96703632,7.25E+12,1501922205,4.76E-05,1.45E-02,4603.581237,344969360,2.59E+13,11559168,614826560,898654813,94930,10416,366476
36936,6590,2715,0.02533638,0.25,6167237,4474496,243408240,17891850,100281240,6.61E+11,261300090,0.006334095,2.75E-01,635190.9009,4185908037,2.76E+13,10641733,24059087,247882736,24347,32803,89582
36886,1104,36185,0.00047003,0.15,19148,5994766,40722144,39948240,1334719910,1.47E+12,80670384,7.05E-05,1.50E-01,94103.75989,103890550.9,1.15E+11,6013914,39967388,46716910,12233,8372,17583
68608,37745,6975,0.00108175,0.13,2801386,34226457,2589608960,263271375,478540800,1.81E+13,2852880335,0.000140628,1.31E-01,67295.99635,2540087382,9.59E+13,37027843,266072761,2623835417,32959,76599,112822
14650,69733,5863,0.00952101,0.07,9727138,28621998,1021588450,408844579,85892950,5.99E+12,1430433029,0.000666471,7.95E-02,57245.13451,3991874965,2.78E+14,38349136,418571717,1050210448,80707,37847,301506
35337,40896,3533,0.00034241,0.17,494847,24566824,1445141952,144485568,124845621,5.11E+12,1589627520,5.82E-05,1.70E-01,7267.226145,297200480.4,1.22E+13,25061671,144980415,1469708776,4402,19852,12354
25995,9051,12183,8.43E-05,0.3,19833,33083781,235280745,110268333,316697085,2.87E+12,345549078,2.53E-05,3.00E-01,8008.319188,72483296.97,6.56E+11,33103614,110288166,268364526,12506,4889,12926
81165,17642,17014,0.02533638,5.00E-04,36281731,150088,1431912930,300160988,1380941310,2.44E+13,1732073918,1.27E-05,2.58E-02,17494.02689,308629622.5,5.45E+12,36431819,336442719,1432063018,1074898,12663,3339952
51516,2445,32346,0.00163948,0.2,206540,15820150,125956620,79085970,1666336536,4.07E+12,205042590,0.000327896,2.02E-01,546385.0848,1335911532,3.27E+12,16026690,79292510,141776770,23502,80163,51398
32152,41437,13492,0.00056263,0.01,749593,5590941,1332282424,559068004,433794784,1.80E+13,1891350428,5.63E-06,1.06E-02,2440.659593,101133611.6,4.19E+12,6340534,559817597,1337873365,23815,9099,68031
59398,50314,20177,0.00370564,0.001,11074702,1015194,2988550972,1015185578,1198473446,6.03E+13,4003736550,3.71E-06,4.71E-03,4441.11114,223450065.9,1.12E+13,12089896,1026260280,2989566166,367280,15863,1205123
80562,96020,7597,0.00082487,0.05,6380934,36477889,7735563240,729463940,612029514,5.88E+13,8465027180,4.12E-05,5.08E-02,25242.23926,2423759814,2.33E+14,42858823,735844874,7772041129,109329,115349,307109
51851,42871,2236,0.00370564,0.27,8237471,25889428,2222904221,95859556,115938836,4.97E+12,2318763777,0.001000523,2.74E-01,115999.4488,4973012371,2.13E+14,34126899,104097027,2248793649,29105,46592,99441
78317,2304,19474,0.01084252,0.3,1956645,13461883,180442368,44868096,1525145258,3.51E+12,225310464,0.003252756,3.11E-01,4960925.389,11429972096,2.63E+13,15418528,46824741,193904251,64871,197538,219064
102293,92149,15717,0.00031941,0.03,3010847,43449860,9426197657,1448305833,1607739081,1.48E+14,10874503490,9.58E-06,3.03E-02,15405.8382,1419632584,1.31E+14,46460707,1451316680,9469647517,139045,117930,171160
147047,16642,3183,0.00163948,0.17,4012309,9007196,2447156174,52971486,468050601,7.79E+12,2500127660,0.000278712,1.72E-01,130451.1319,2170967737,3.61E+13,13019505,56983795,2456163370,45055,72046,95389
35599,9585,38332,0.00108175,0.03,369118,11022608,341216415,367412220,1364580868,1.31E+13,708628635,3.25E-05,3.11E-02,44284.06062,424462721,4.07E+12,11391726,367781338,352239023,33146,32727,92911
13153,76904,23956,0.00860544,0.005,8704881,9211673,1011518312,1842312224,315093268,2.42E+13,2853830536,4.30E-05,1.36E-02,13557.58106,1042632214,8.02E+13,17916554,1851017105,1020729985,285556,36644,1109204
99388,95942,2157,0.00370564,0.01,35335477,2069510,9535483496,206946894,214379916,2.06E+13,9742430390,3.71E-05,1.37E-02,7944.147919,762177439.7,7.31E+13,37404987,242282371,9537553006,204750,26649,473134
36173,25067,26327,8.43E-05,0.05,76429,32997420,906748591,659938909,952326571,2.39E+13,1566687500,4.21E-06,5.01E-02,4013.580333,100608418.2,2.52E+12,33073849,660015338,939746011,30934,14537,35971
39842,1425,32746,0.01084252,0.3,615624,13999723,56774850,46663050,1304666132,1.86E+12,103437900,0.003252756,3.11E-01,4243760.589,6047358839,8.62E+12,14615347,47278674,70774573,35894,152135,115957
116813,8656,13214,0.00182521,0.15,1845678,17158782,1011133328,114380384,1543566982,1.34E+13,1125513712,0.000273782,1.52E-01,422600.0837,3658026324,3.17E+13,19004460,116226062,1028292110,62586,173197,171592
93625,60734,3466,8.43E-05,0.1,479297,21052577,5686220750,210504044,324504250,1.97E+13,5896724794,8.43E-06,1.00E-01,2735.246323,166122450.2,1.01E+13,21531874,210983341,5707273327,11605,13035,16334
23399,92273,11825,0.00491597,0.05,10614466,54558606,2159095927,1091128225,276693175,2.55E+13,3250224152,0.000245799,5.49E-02,68010.76738,6275557538,5.79E+14,65173072,1101742691,2213654533,207179,95641,697282
130944,7357,2193,0.00491597,0.3,4735839,4841866,963355008,16133901,287160192,2.11E+12,979488909,0.001474791,3.05E-01,423501.2667,3115698819,2.29E+13,9577705,20869740,968196874,33689,58310,73175
127540,34581,6895,0.00296184,0.1,13063152,23844034,4410460740,238435995,879388300,3.04E+13,4648896735,0.000296184,1.03E-01,260460.7442,9006992997,3.11E+14,36907186,251499147,4434304774,295133,197623,626736
7929,9555,22561,0.00296184,0.15,224421,32336795,75761595,215570355,178886169,1.71E+12,291331950,0.000444276,1.53E-01,79474.83162,759382016.1,7.26E+12,32561216,215794776,108098390,8424,18920,29925
78524,34189,1356,0.02533638,0.27,68020463,12526240,2684657036,46360284,106478544,3.64E+12,2731017320,0.006840823,2.95E-01,728400.8302,24903295984,8.52E+14,80546703,114380747,2697183276,156229,188039,187206
62222,59948,419,0.00952101,0.03,35514661,754069,3730084456,25118212,26071018,1.56E+12,3755202668,0.00028563,3.95E-02,7446.672693,446413134.6,2.68E+13,36268730,60632873,3730838525,23282,5833,80045
42429,42459,21720,0.00163948,0.005,2953623,4611198,1801492911,922209480,921557880,3.91E+13,2723702391,8.20E-06,6.64E-03,7554.378566,320751359.5,1.36E+13,7564821,925163103,1806104109,100520,25055,359834
74122,41736,4434,0.00182521,0.07,5646540,12956914,3093555792,185057424,328656948,1.37E+13,3278613216,0.000127765,7.18E-02,41990.75636,1752526208,7.32E+13,18603454,190703964,3106512706,49504,51100,148751
81158,19385,23201,0.01084252,0.15,17058303,67463688,1573247830,449751385,1882946758,3.65E+13,2022999215,0.001626378,1.61E-01,3062383.182,59364297990,1.15E+15,84521991,466809688,1640711518,713878,667374,2175378
44352,1690,29775,0.00047003,0.27,35251,13594279,74954880,50319750,1320580800,2.23E+12,125274630,0.000126908,2.70E-01,167592.4002,283231156.4,4.79E+11,13629530,50355001,88549159,13580,19569,21025
5211,22027,8867,0.02533638,0.13,2908344,25393712,114782697,195313409,46205937,1.02E+12,310096106,0.003293729,1.55E-01,152189.8532,3352285895,7.39E+13,28302056,198221753,140176409,30528,26308,135179
37321,9144,21010,0.00056263,0.03,192024,5764014,341263224,192115440,784114210,7.17E+12,533378664,1.69E-05,3.06E-02,13234.98534,121020705.9,1.11E+12,5956038,192307464,347027238,14720,10135,18647
64549,12156,3544,0.00082185,0.27,644906,11632615,784657644,43080864,228761656,2.78E+12,827738508,0.0002219,2.71E-01,50762.09709,617064052.2,7.50E+12,12277521,43725770,796290259,7491,25247,15002
18029,15509,16930,0.00108175,0.15,302494,39388671,279611761,262567370,305230970,4.73E+12,542179131,0.000162263,1.51E-01,49527.54027,768122622,1.19E+13,39691165,262869864,319000432,9511,31545,31631
38096,79519,12287,0.00296184,5.00E-04,8972688,488551,3029355824,977049953,468085552,3.72E+13,4006405777,1.48E-06,3.46E-03,693.1972557,55122352.57,4.38E+12,9461239,986022641,3029844375,177918,3692,599939
149249,28237,4499,1.65E-05,0.25,69581,31763777,4214344013,127038263,671471251,1.90E+13,4341382276,4.13E-06,2.50E-01,2771.497589,78258777.41,2.21E+12,31833358,127107844,4246107790,17961,5847,16301
73745,8874,21035,0.00019487,0.13,127534,24268210,654413130,186664590,1551226075,1.38E+13,841077720,2.53E-05,1.30E-01,39297.36528,348724819.5,3.10E+12,24395744,186792124,678681340,25110,28265,37489
146971,24597,2151,0.00108175,0.23,3910608,12169905,3615045687,52908147,316134621,7.78E+12,3667953834,0.000248803,2.31E-01,78655.08404,1934679102,4.76E+13,16080513,56818755,3627215592,32406,54953,70740
37191,79610,13695,2.48E-05,0.05,73518,54513619,2960775510,1090258950,509330745,4.05E+13,4051034460,1.24E-06,5.00E-02,632.3341199,50340119.29,4.01E+12,54587137,1090332468,3015289129,16678,5590,48627
84888,12868,14280,0.00078778,0.15,860545,27565358,1092338784,183755040,1212200640,1.56E+13,1276093824,0.000118167,1.51E-01,143242.113,1843239510,2.37E+13,28425903,184615585,1119904142,39036,118422,84722
43956,73655,18027,1.65E-05,0.03,53453,39834529,3237579180,1327778685,792394812,5.84E+13,4565357865,4.95E-07,3.00E-02,392.4731504,28907609.89,2.13E+12,39887982,1327832138,3277413709,20290,3049,29526
22681,37576,8495,0.01084252,0.001,9240765,319239,852261256,319208120,192675095,7.24E+12,1171469376,1.08E-05,1.18E-02,2089.083571,78499404.27,2.95E+12,9560004,328448885,852580495,109994,3869,413604
66504,78876,13818,0.00370564,0.05,19438339,54499296,5245569504,1089908568,918952272,7.25E+13,6335478072,0.000185282,5.37E-02,170265.3149,13429846975,1.06E+15,73937635,1109346907,5300068800,469914,236937,1484030
97210,14396,17648,0.00296184,0.03,4145168,7622660,1399435160,254060608,1715562080,2.47E+13,1653495768,8.89E-05,3.30E-02,152436.6117,2194477462,3.16E+13,11767828,258205776,1407057820,178064,132980,452727
36175,27555,49444,0.00860544,0.05,8578138,68124160,996802125,1362429420,1788636700,4.93E+13,2359231545,0.000430272,5.86E-02,769600.2902,21206335996,5.84E+14,76702298,1371007558,1064926285,665320,314825,2276380
55220,10260,1949,0.02533638,0.15,14354821,3000325,566557200,19996740,107623780,1.10E+12,586553940,0.003800457,1.75E-01,409019.5481,4196540563,4.31E+13,17355146,34351561,569557525,41622,36485,146256
82834,27528,11551,0.00370564,0.07,8450081,22259394,2280254352,317975928,956815534,2.63E+13,2598230280,0.000259395,7.37E-02,248192.9741,6832256190,1.88E+14,30709475,326426009,2302513746,201286,169476,565542
70521,19135,12614,0.00370564,0.2,5000685,48278074,1349419335,241368890,889551894,1.70E+13,1590788225,0.000741128,2.04E-01,659271.8161,12615166201,2.41E+14,53278759,246369575,1397697409,113380,222126,349495
83451,63753,17257,8.43E-05,0.01,448446,11002092,5320251603,1100185521,1440113907,9.18E+13,6420437124,8.43E-07,1.01E-02,1213.872012,77387982.39,4.93E+12,11450538,1100633967,5331253695,40558,6454,85823
79855,32646,1287,0.01084252,0.03,28266198,1261417,2606946330,42015402,102773385,3.36E+12,2648961732,0.000325276,4.08E-02,33429.67447,1091345153,3.57E+13,29527615,70281600,2608207747,65778,18329,197454
140937,17416,2260,0.00108175,0.01,2655309,393700,2454558792,39360160,318517620,5.55E+12,2493918952,1.08E-05,1.11E-02,3445.564354,60007948.8,1.05E+12,3049009,42015469,2454952492,19156,4033,48539
114692,29598,3132,0.00078778,0.15,2674339,13907366,3394653816,92700936,359215344,1.06E+13,3487354752,0.000118167,1.51E-01,42447.39955,1256358132,3.72E+13,16581705,95375275,3408561182,24516,54248,60826
112408,39653,3825,0.00013363,0.03,595644,4550693,4457314424,151672725,429960600,1.70E+13,4608987149,4.01E-06,3.01E-02,1723.669049,68348648.81,2.71E+12,5146337,152268369,4461865117,10558,5447,12566
98800,40382,2182,0.00370564,0.23,14784635,20269144,3989741600,88113524,215581600,8.71E+12,4077855124,0.000852297,2.34E-01,183739.5941,7419772287,3.00E+14,35053779,102898159,4010010744,79983,78570,200090
145900,29249,749,0.00082487,0.1,3520111,2193534,4267429100,21907501,109279100,3.20E+12,4289336601,8.25E-05,1.01E-01,9014.105122,263653560.7,7.72E+12,5713645,25427612,4269622634,9352,14734,20496
123048,50105,6047,1.65E-05,0.13,101791,39389913,6165320040,302984935,744071256,3.73E+13,6468304975,2.15E-06,1.30E-01,1597.000137,80017691.85,4.01E+12,39491704,303086726,6204709953,24526,6751,21663
51088,4313,38837,2.48E-05,0.25,5471,41877684,220342544,167503981,1984104656,8.56E+12,387846525,6.21E-06,2.50E-01,12316.32965,53120329.79,2.29E+11,41883155,167509452,262220228,29194,3839,23161
5814,74342,3779,0.00160539,0.15,693896,42147719,432224388,280938418,21971106,1.63E+12,713162806,0.000240808,1.52E-01,5290.829079,393330815.4,2.92E+13,42841615,281632314,474372107,6581,5512,17948
83689,6552,20717,0.00078778,0.25,432003,33938337,548330328,135737784,1733785013,1.14E+13,684068112,0.000196945,2.51E-01,341460.2894,2237247816,1.47E+13,34370340,136169787,582268665,37481,142649,71849
45989,23295,46367,0.00041097,0.05,440296,54008623,1071313755,1080119265,2132371963,4.97E+13,2151433020,2.05E-05,5.04E-02,43817.04528,1020718070,2.38E+13,54448919,1080559561,1125322378,70096,104981,159666
84372,12935,8310,0.00296184,0.3,3232427,32249286,1091351820,107489850,701131320,9.07E+12,1198841670,0.000888552,3.03E-01,622991.6366,8058396820,1.04E+14,35481713,110722277,1123601106,58082,149046,158336
78857,9775,6845,0.02533638,0.15,19530045,10037439,770827175,66909875,539776165,5.28E+12,837737050,0.003800457,1.75E-01,2051396.105,20052396924,1.96E+14,29567484,86439920,780864614,223636,205157,716857
84464,33862,3693,0.00041097,0.27,1175461,33766314,2860119968,125052366,311925552,1.06E+13,2985172334,0.000110962,2.70E-01,34611.85191,1172026529,3.97E+13,34941775,126227827,2893886282,21096,44875,29759
85608,1185,16673,0.00491597,0.3,498919,5929883,101445480,19757505,1427342184,1.69E+12,121202985,0.001474791,3.05E-01,2105031.407,2494462217,2.96E+12,6428802,20256424,107375363,23803,116489,56970
122798,80676,2614,0.00031941,0.25,3164380,52737410,9906851448,210887064,320993972,2.59E+13,10117738512,7.99E-05,2.50E-01,25632.17115,2067901040,1.67E+14,55901790,214051444,9959588858,45809,67362,63005
103489,82431,15848,8.43E-05,0.03,719056,39191679,8530701759,1306366488,1640093672,1.35E+14,9837068247,2.53E-06,3.01E-02,4147.304868,341866487.6,2.82E+13,39910735,1307085544,8569893438,59461,36326,126652
89328,58272,4475,0.00296184,0.005,15417465,1304133,5205321216,260767200,399742800,2.33E+13,5466088416,1.48E-05,7.96E-03,5919.871074,344962727.2,2.01E+13,16721598,276184665,5206625349,157031,24984,405243
62017,15100,12497,0.00860544,0.005,8058934,943624,936456700,188704700,775026449,1.17E+13,1125161400,4.30E-05,1.36E-02,33347.21803,503542992.2,7.60E+12,9002558,196763634,937400324,163160,32038,527968
137649,41214,3684,0.00952101,0.3,54014637,45552213,5673065886,151832376,507098916,2.09E+13,5824898262,0.002856303,3.10E-01,1448428.155,59695517983,2.46E+15,99566850,205847013,5718618099,635772,566427,1377951
133800,71093,3860,0.00034241,0.15,3257110,41167728,9512243400,274418980,516468000,3.67E+13,9786662380,5.14E-05,1.50E-01,26526.57118,1885853525,1.34E+14,44424838,277676090,9553411128,42697,88024,100226
96243,11699,14317,0.00034241,0.27,385553,45227519,1125946857,167494583,1377911031,1.61E+13,1293441440,9.25E-05,2.70E-01,127388.8394,1490322032,1.74E+13,45613072,167880136,1171174376,31069,106502,49152
30799,73968,1634,0.00082487,0.25,1879198,30231397,2278140432,120863712,50325566,3.72E+12,2399004144,0.000206218,2.51E-01,10378.01241,767640821.7,5.68E+13,32110595,122742910,2308371829,5139,9170,17820
81916,11839,2888,0.00370564,0.17,3593777,5813800,969803524,34191032,236573408,2.80E+12,1003994556,0.000629959,1.74E-01,149031.5002,1764383931,2.09E+13,9407577,37784809,975617324,21861,38800,59331
122333,30907,8624,0.00296184,0.2,11198692,53310681,3780946031,266541968,1054999792,3.26E+13,4047487999,0.000592368,2.03E-01,624948.1168,19315271446,5.97E+14,64509373,277740660,3834256712,332941,308527,671466
95026,34277,7110,0.00082282,0.07,2680162,17061553,3257206202,243709470,675634860,2.32E+13,3500915672,5.76E-05,7.08E-02,38914.81129,1333882986,4.57E+13,19741715,246389632,3274267755,48372,79110,128900
38113,47946,17579,0.00163948,0.01,2996014,8428636,1827365898,842842734,669988427,3.21E+13,2670208632,1.64E-05,1.16E-02,10984.32626,526654507,2.53E+13,11424650,845838748,1835794534,86396,34443,286049
83857,28676,21086,2.48E-05,0.05,59708,30233289,2404683332,604662136,1768208702,5.07E+13,3009345468,1.24E-06,5.00E-02,2195.231104,62950447.12,1.81E+12,30292997,604721844,2434916621,32031,4931,36929
42629,10613,23673,0.00296184,0.005,1340071,1256277,452421577,251241549,1009156317,1.07E+13,703663126,1.48E-05,7.96E-03,14944.79773,158609138.3,1.68E+12,2596348,252581620,453677854,48493,11341,174917
96630,63544,2636,0.00491597,0.15,30185858,25131143,6140256720,167501984,254716680,1.62E+13,6307758704,0.000737396,1.55E-01,187826.9336,11935274669,7.59E+14,55317001,197687842,6165387863,222254,135057,478976
34934,38196,2189,0.00860544,0.23,11483048,19234364,1334339064,83611044,76470526,2.92E+12,1417950108,0.001979251,2.39E-01,151354.3804,5781131912,2.21E+14,30717412,95094092,1353573428,38554,42885,128978
50174,13136,4728,0.00108175,0.27,713000,16771400,659085664,62107008,237222672,3.12E+12,721192672,0.000292073,2.71E-01,69286.21887,910143771,1.20E+13,17484400,62820008,675857064,9687,30232,20122
94870,79073,1688,0.00182521,0.17,13692307,22692559,7501655510,133475224,160140560,1.27E+13,7635130734,0.000310286,1.72E-01,49689.32576,3929084056,3.11E+14,36384866,147167531,7524348069,59074,56206,147721
31340,38485,10214,0.00860544,0.15,10379285,58966077,1206119900,393085790,320106760,1.23E+13,1599205690,0.001290816,1.59E-01,413198.9275,15901960725,6.12E+14,69345362,403465075,1265085977,157551,148568,543398
45245,62446,3331,0.00078778,0.3,2225849,62409776,2825369270,208007626,150711095,9.41E+12,3033376896,0.000236334,3.01E-01,35618.15593,2224211365,1.39E+14,64635625,210233475,2887779046,11882,32779,55557
34501,95236,4138,0.00082487,0.05,2710407,19708694,3285737236,394086568,142765138,1.36E+13,3679823804,4.12E-05,5.08E-02,5888.133969,560762326.7,5.34E+13,22419101,396796975,3305445930,18931,19469,64070
102673,87802,1960,0.00015297,0.15,1379024,25825028,9014894746,172091920,201239080,1.77E+13,9186986666,2.29E-05,1.50E-01,4617.53131,405428484.1,3.56E+13,27204052,173470944,9040719774,15328,22402,21386
106716,6058,15324,0.00019487,0.17,125985,15782445,646485528,92832792,1635315984,9.91E+12,739318320,3.31E-05,1.70E-01,54174.58439,328189632.2,1.99E+12,15908430,92958777,662267973,18437,23662,33521
130034,10558,1369,0.00082282,0.17,1129696,2458915,1372898972,14453902,178016546,1.88E+12,1387352874,0.000139879,1.71E-01,24900.84764,262903149.4,2.78E+12,3588611,15583598,1375357887,5036,16428,12018
48431,20929,13551,0.00491597,0.13,4983018,36870265,1013612399,283608879,656288481,1.37E+13,1297221278,0.000639076,1.35E-01,419418.2829,8778005243,1.84E+14,41853283,288591897,1050482664,122670,126944,354559
75942,25749,14748,0.00296184,0.1,5791819,37977426,1955430558,379746252,1119992616,2.88E+13,2335176810,0.000296184,1.03E-01,331723.893,8541558520,2.20E+14,43769245,385538071,1993407984,163919,203671,467906
120984,19029,15410,0.00491597,0.17,11317650,49853150,2302204536,293236890,1864363440,3.55E+13,2595441426,0.000835715,1.75E-01,1558076.306,29648634024,5.64E+14,61170800,304554540,2352057686,558283,493935,1216149
57166,65266,21849,0.00952101,0.001,35522954,1426006,3730996156,1425996834,1249019934,8.15E+13,5156992990,9.52E-06,1.05E-02,11891.93128,776138787,5.07E+13,36948960,1461519788,3732422162,1227013,48914,4016406
46187,781,41982,0.00163948,0.27,59198,8861628,36072047,32787942,1939022634,1.51E+12,68859989,0.00044266,2.72E-01,858326.9836,670353374.2,5.25E+11,8920826,32847140,44933675,18625,39425,31051
31416,31011,14088,0.00182521,0.13,1778248,56798857,974241576,436882968,442588608,1.37E+13,1411124544,0.000237277,1.32E-01,105016.2299,3256658306,1.01E+14,58577105,438661216,1031040433,61996,76516,137527
26094,11484,43209,0.00182521,0.07,546972,34736264,299663496,496212156,1127495646,1.29E+13,795875652,0.000127765,7.18E-02,144054.143,1654317778,1.90E+13,35283236,496759128,334399760,46928,96047,143931
102226,64341,11273,0.00491597,5.00E-04,32334201,362691,6577323066,725316093,1152393698,7.41E+13,7302639159,2.46E-06,5.42E-03,2832.566424,182250156.3,1.17E+13,32696892,757650294,6577685757,984482,10120,2282682
129249,66803,5953,8.43E-05,0.15,727790,59656462,8634220947,397678259,769419297,5.14E+13,9031899206,1.26E-05,1.50E-01,9728.152882,649869797,4.34E+13,60384252,398406049,8693877409,33018,62787,43179
138756,92150,2193,0.00034241,0.27,4378237,54579993,12786365400,202084950,304291908,2.80E+13,12988450350,9.25E-05,2.70E-01,28131.9999,2592363791,2.39E+14,58958230,206463187,12840945393,55775,62037,86507
123355,5859,13526,0.00296184,0.13,2140997,10304400,722736945,79248834,1668499730,9.78E+12,801985779,0.000385039,1.33E-01,642437.8012,3764043077,2.21E+13,12445397,81389831,733041345,79657,179412,203955
53856,28318,20410,0.00015297,0.07,233303,40459631,1525094208,577970380,1099200960,3.11E+13,2103064588,1.07E-05,7.02E-02,11770.13396,333306653.5,9.44E+12,40692934,578203683,1565553839,34614,31084,41189
3712,6927,29965,0.00370564,0.13,95307,26986123,25713024,207567555,111230080,7.70E+11,233280579,0.000481733,1.34E-01,53583.22237,371170981.4,2.57E+12,27081430,207662862,52699147,5683,16268,17945
140467,7457,3580,0.00082185,0.27,860870,7209031,1047462419,26696060,502871860,3.75E+12,1074158479,0.0002219,2.71E-01,111587.0143,832104365.6,6.21E+12,8069901,27556930,1054671450,11089,46705,26845
29658,13200,25169,0.00015297,0.17,59889,56482074,391485600,332230800,746462202,9.85E+12,723716400,2.60E-05,1.70E-01,19411.67492,256234108.9,3.38E+12,56541963,332290689,447967674,35322,28430,25855
60567,40756,26601,0.00082282,0.05,2031142,54208257,2468468652,1084150356,1611142767,6.57E+13,3552619008,4.11E-05,5.08E-02,66284.02458,2701471706,1.10E+14,56239399,1086181498,2522676909,110324,178256,330095
81030,77505,13691,2.48E-05,0.05,155941,53058717,6280230150,1061120955,1109381730,8.60E+13,7341351105,1.24E-06,5.00E-02,1377.297418,106747436.4,8.27E+12,53214658,1061276896,6333288867,42930,9565,51303
64024,3783,14414,0.00031941,0.2,77376,10908429,242202792,54528162,922841936,3.49E+12,296730954,6.39E-05,2.00E-01,58952.98856,223019155.7,8.44E+11,10985805,54605538,253111221,10723,14163,17424
36628,54430,39270,0.01084252,0.01,21616675,21375423,1993662040,2137466100,1438381560,7.83E+13,4131128140,0.000108425,2.08E-02,155956.8083,8488729077,4.62E+14,42992098,2159082775,2015037463,1314669,199920,4354441
53186,1287,8661,0.00860544,0.25,589116,2787289,68450382,11146707,460643946,5.93E+11,79597089,0.00215136,2.59E-01,991010.9597,1275431105,1.64E+12,3376405,11735823,71237671,10255,44727,30428
34417,1747,45555,0.00182521,0.05,109755,3979659,60126499,79584585,1567866435,2.74E+12,139711084,9.13E-05,5.18E-02,143084.2748,249968228.1,4.37E+11,4089414,79694340,64106158,18585,16654,41599
61712,4078,13587,0.00082185,0.27,206835,14961461,251661536,55407786,838480944,3.42E+12,307069322,0.0002219,2.71E-01,186058.5022,758746572.1,3.09E+12,15168296,55614621,266622997,12740,47698,25132
9633,54419,3999,0.00018467,0.23,96810,50056127,524218227,217621581,38522367,2.10E+12,741839808,4.25E-05,2.30E-01,1636.202868,89040523.88,4.85E+12,50152937,217718391,574274354,3083,4361,5103
101444,16282,11489,0.00182521,0.01,3014850,1870724,1651711208,187063898,1165490116,1.90E+13,1838775106,1.83E-05,1.18E-02,21272.64215,346361159.4,5.64E+12,4885574,190078748,1653581932,89134,25286,226179
8385,43049,18200,0.00082185,0.07,296682,54846552,360965865,783491800,152607000,6.57E+12,1144457665,5.75E-05,7.08E-02,8779.404407,377944580.3,1.63E+13,55143234,783788482,415812417,16980,15383,39547
72860,65820,10732,0.00860544,0.03,41269493,21192706,4795645200,706380240,781933520,5.15E+13,5502025440,0.000258163,3.86E-02,201866.4597,13286850378,8.75E+14,62462199,747649733,4816837906,744925,213040,2363068
55104,10152,26318,0.00078778,0.03,440706,8015772,559415808,267180336,1450227072,1.47E+13,826596144,2.36E-05,3.08E-02,34273.79648,347947581.9,3.53E+12,8456478,267621042,567431580,29525,27268,78504
105402,14956,1559,0.00056263,0.23,886957,5363109,1576392312,23316404,164321718,2.46E+12,1599708716,0.000129405,2.31E-01,21264.03549,318024914.7,4.76E+12,6250066,24203361,1581755421,5159,18145,11942
140088,93435,867,0.00108175,0.23,14159292,18648147,13089122280,81008145,121456296,1.13E+13,13170130425,0.000248803,2.31E-01,30218.63009,2823477702,2.64E+14,32807439,95167437,13107770427,46808,43520,92330
41574,22345,48113,0.00160539,0.03,1491395,32252961,928971030,1075084985,2000249862,4.47E+13,2004056015,4.82E-05,3.16E-02,96335.43378,2152615268,4.81E+13,33744356,1076576380,961223991,118470,138060,405632
76811,62416,6628,0.00056263,0.03,2697433,12411807,4794235376,413693248,509103308,3.18E+13,5207928624,1.69E-05,3.06E-02,8593.103825,536347168.4,3.35E+13,15109240,416390681,4806647183,39751,36319,115218
40299,18926,19782,0.00082487,0.17,629160,63650958,762698874,374394132,797194818,1.51E+13,1137093006,0.000140228,1.71E-01,111788.9552,2115717766,4.00E+13,64280118,375023292,826349832,21550,100335,76176
131798,21787,10199,0.00015297,0.23,439258,51108506,2871483026,222205613,1344207802,2.93E+13,3093688639,3.52E-05,2.30E-01,47293.39752,1030381252,2.24E+13,51547764,222644871,2922591532,32713,79621,53048
34601,31225,3279,0.00860544,0.25,9297808,25597661,1080416225,102386775,113456679,3.54E+12,1182803000,0.00215136,2.59E-01,244086.1609,7621590375,2.38E+14,34895469,111684583,1106013886,45269,55857,156713
14254,77754,5421,0.00034241,0.07,379503,29509723,1108305516,421504434,77270934,6.01E+12,1529809950,2.40E-05,7.03E-02,1852.083836,144006926.6,1.12E+13,29889226,421883937,1137815239,8653,7524,17669
113349,51649,8420,0.00296184,0.1,17340073,43493487,5854362501,434884580,954398580,4.93E+13,6289247081,0.000296184,1.03E-01,282677.589,14600014795,7.54E+14,60833560,452224653,5897855988,447731,276452,966861
123944,36026,9723,0.00041097,0.17,1835078,59549860,4465206544,350280798,1205107512,4.34E+13,4815487342,6.99E-05,1.70E-01,84194.71582,3033198832,1.09E+14,61384938,352115876,4524756404,60475,168050,137830
47983,6395,5719,0.00019487,0.27,59806,9877368,306851285,36573005,274414777,1.75E+12,343424290,5.26E-05,2.70E-01,14438.30605,92332967.19,5.91E+11,9937174,36632811,316728653,4713,5877,6874
113168,68505,1672,0.00019487,0.25,1510772,28650228,7752573840,114540360,189216896,1.30E+13,7867114200,4.87E-05,2.50E-01,9218.174131,631491018.8,4.33E+13,30161000,116051132,7781224068,6627,26317,20307
120261,98763,13884,0.00013363,0.03,1587188,41137929,11877337143,1371225492,1669703724,1.65E+14,13248562635,4.01E-06,3.01E-02,6693.675259,661087449.6,6.53E+13,42725117,1372812680,11918475072,78977,64466,200477
52223,73235,2648,8.43E-05,0.2,322375,38790803,3824551405,193926280,138286504,1.01E+13,4018477685,1.69E-05,2.00E-01,2331.233884,170727913.5,1.25E+13,39113178,194248655,3863342208,4320,10907,9453
19408,1386,21340,0.00108175,0.17,29119,5031535,26899488,29577240,414166720,5.74E+11,56476728,0.000183898,1.71E-01,76164.22439,105563615,1.47E+11,5060654,29606359,31931023,4702,5411,7749
60730,16223,16481,2.09E-05,0.15,20571,40107448,985222790,267371263,1000891130,1.62E+13,1252594053,3.13E-06,1.50E-01,3134.791019,50855714.7,8.25E+11,40128019,267391834,1025330238,23220,4023,28176
65547,93438,2879,0.00952101,0.2,58312915,53812096,6124580586,269008002,188709813,1.76E+13,6393588588,0.001904202,2.10E-01,359341.6033,33576160732,3.14E+15,112125011,327320917,6178392682,259926,253615,870746
45527,5045,18417,0.00082282,0.15,188993,13937699,229683715,92913765,838470759,4.23E+12,322597480,0.000123423,1.51E-01,103486.5765,522089778.4,2.63E+12,14126692,93102758,243621414,14039,33180,30945
128384,10670,12003,0.00370564,0.2,5076649,25618254,1369857280,128072010,1540993152,1.64E+13,1497929290,0.000741128,2.04E-01,1142073.173,12185920753,1.30E+14,30694903,133148659,1395475534,191950,268818,414415
46335,1695,23114,0.00082282,0.13,64656,5095780,78537825,39178230,1070987190,1.82E+12,117716055,0.000106967,1.31E-01,114559.8584,194178959.9,3.29E+11,5160436,39242886,83633605,10664,12660,18903
16715,24577,48863,0.00082487,0.005,338888,6004768,410804555,1200905951,816745045,2.01E+13,1611710506,4.12E-06,5.82E-03,3368.542426,82788667.21,2.03E+12,6343656,1201244839,416809323,40007,7005,110107
91212,82354,19952,0.00078778,0.001,5917606,1643156,7511673048,1643127008,1819861824,1.50E+14,9154800056,7.88E-07,1.79E-03,1433.650748,118066873.7,9.72E+12,7560762,1649044614,7513316204,276689,9849,751413
72968,14507,20982,0.00047003,0.005,497561,1522015,1058546776,304385874,1531014576,2.22E+13,1362932650,2.35E-06,5.47E-03,3598.113906,52197838.43,7.57E+11,2019576,304883435,1060068791,28617,3659,75007
142586,4318,12859,0.00019487,0.23,119994,12772463,615686348,55525162,1833513374,7.92E+12,671211510,4.48E-05,2.30E-01,82178.25277,354845695.5,1.53E+12,12892457,55645156,628458811,18603,24670,32506
86838,9468,13748,0.00056263,0.17,462599,22130378,822182184,130166064,1193848824,1.13E+13,952348248,9.56E-05,1.71E-01,114188.1779,1081133668,1.02E+13,22592977,130628663,844312562,27303,78186,51681
26551,1524,12511,0.00163948,0.15,66361,2861140,40463724,19066764,332179561,5.06E+11,59530488,0.000245922,1.52E-01,81690.262,124495959.3,1.90E+11,2927501,19133125,43324864,4015,7907,7948
129002,34588,16176,0.00019487,0.01,869514,5595155,4461921176,559495488,2086736352,7.22E+13,5021416664,1.95E-06,1.02E-02,4066.423129,140649443.2,4.87E+12,6464669,560365002,4467516331,46965,12933,124016
79078,16351,11937,0.00056263,0.17,727491,33182887,1293004378,195181887,943954086,1.54E+13,1488186265,9.56E-05,1.71E-01,90286.47086,1476274085,2.41E+13,33910378,195909378,1326187265,32763,98633,58787
17421,3158,39206,0.02533638,0.15,1394308,18576760,55015518,123812548,683007726,2.16E+12,178828066,0.003800457,1.75E-01,2595741.493,8197351636,2.59E+13,19971068,125206856,73592278,68101,110472,278989
39883,47133,23406,0.00108175,0.001,2033552,1103223,1879805439,1103194998,933501498,4.40E+13,2983000437,1.08E-06,2.08E-03,1009.815245,47595621.96,2.24E+12,3136775,1105228550,1880908662,74286,3267,269512
5125,19189,15150,0.00082282,0.17,80930,49425962,98343625,290713350,77643750,1.49E+12,389056975,0.000139879,1.71E-01,10860.76116,208407146,4.00E+12,49506892,290794280,147769587,5490,8380,11097
25503,65751,31716,0.00860544,0.01,14430590,20854008,1676847753,2085358716,808853148,5.32E+13,3762206469,8.61E-05,1.86E-02,69605.37234,4576622837,3.01E+14,35284598,2099789306,1697701761,673712,114277,2370058
123501,14829,9360,0.00018467,0.15,338220,20822730,1831396329,138799440,1155969360,1.71E+13,1970195769,2.77E-05,1.50E-01,32020.92926,474838359.9,7.04E+12,21160950,139137660,1852219059,22228,40837,37531
14103,73470,12195,0.00078778,0.01,816312,8960188,1036147410,895966650,171986085,1.26E+13,1932114060,7.88E-06,1.08E-02,1354.87198,99542444.4,7.31E+12,9776500,896782962,1045107598,22412,11229,65148
72801,50658,5087,0.00952101,0.1,35113312,25772572,3687953058,257697246,370338687,1.88E+13,3945650304,0.000952101,1.10E-01,352599.8342,17862002402,9.05E+14,60885884,292810558,3713725630,305298,188873,925619
25286,837,36945,0.00370564,0.15,78459,4640342,21164382,30922965,934191270,7.82E+11,52087347,0.000555846,1.54E-01,519266.4807,434626044.3,3.64E+11,4718801,31001424,25804724,10772,25989,23001
35836,24232,6056,0.00082185,0.03,713690,4402905,868377952,146748992,217022816,5.26E+12,1015126944,2.47E-05,3.08E-02,5350.80604,129660732,3.14E+12,5116595,147462682,872780857,9135,9759,27855
133475,98824,8825,0.00013363,0.05,1762667,43609990,13190533400,872121800,1177916875,1.16E+14,14062655200,6.68E-06,5.01E-02,7870.2516,777769744.1,7.69E+13,45372657,873884467,13234143390,62726,67538,144204
78366,10506,5314,0.00047003,0.3,387003,16751582,823313196,55828884,416436924,4.38E+12,879142080,0.000141009,3.00E-01,58721.35422,616926547.4,6.48E+12,17138585,56215887,840064778,12158,34916,21571
120986,60571,3701,0.00015297,0.23,1121006,51573176,7328243006,224173271,447769186,2.71E+13,7552416277,3.52E-05,2.30E-01,15753.90805,954229964.4,5.78E+13,52694182,225294277,7379816182,32465,56019,34830
133870,85107,6374,0.00108175,0.001,12324834,542527,11393274090,542472018,853287380,7.26E+13,11935746108,1.08E-06,2.08E-03,923.0436233,78557473.65,6.69E+12,12867361,554796852,11393816617,275225,8386,575152
15715,40226,9712,0.02533638,5.00E-04,16017199,195342,632151590,390674912,152624080,6.14E+12,1022826502,1.27E-05,2.58E-02,1933.470844,77775798.17,3.13E+12,16212541,406692111,632346932,212364,3759,805191
85870,64383,3022,0.00160539,0.01,8875600,1945748,5528568210,194565426,259499140,1.67E+13,5723133636,1.61E-05,1.16E-02,4165.973244,268217855.3,1.73E+13,10821348,203441026,5530513958,63006,18973,163687
149508,3241,14350,0.00108175,0.13,524280,6047541,484555428,46508350,2145439800,6.95E+12,531063778,0.000140628,1.31E-01,301707.8355,977835094.8,3.17E+12,6571821,47032630,490602969,30752,65324,70935
30363,73196,24908,0.00047003,0.005,1044622,9116093,2222450148,1823165968,756281604,5.54E+13,4045616116,2.35E-06,5.47E-03,1777.375212,130096756,9.52E+12,10160715,1824210590,2231566241,62144,11843,171142
15316,34330,5144,0.00018467,0.25,97106,44151213,525798280,176593520,78785504,2.70E+12,702391800,4.62E-05,2.50E-01,3637.329756,124869530.5,4.29E+12,44248319,176690626,569949493,3166,6855,4851
10091,10189,23876,0.00163948,0.03,168586,7298613,102817199,243272564,240932716,2.45E+12,346089763,4.92E-05,3.16E-02,11850.13108,120740985.5,1.23E+12,7467199,243441150,110115812,11108,9520,27257
83522,10329,5803,0.00013363,0.25,115287,14986207,862698738,59939187,484678166,5.01E+12,922637925,3.34E-05,2.50E-01,16191.88583,167245988.7,1.73E+12,15101494,60054474,877684945,7778,11870,12390
7300,20423,36760,0.00491597,0.05,733007,37538078,149087900,750749480,268348000,5.48E+12,899837380,0.000245799,5.49E-02,65959.53588,1347091601,2.75E+13,38271085,751482487,186625978,49636,39997,162760
146116,15989,8028,0.00013363,0.3,312211,38513493,2336248724,128359692,1173019248,1.88E+13,2464608416,4.01E-05,3.00E-01,47025.16863,751885421.3,1.20E+13,38825704,128671903,2374762217,27881,62497,36285
50986,17220,39483,0.01084252,0.005,9520181,3399679,877978920,679897260,2013080238,3.47E+13,1557876180,5.42E-05,1.58E-02,109134.3137,1879292882,3.24E+13,12919860,689417441,881378599,571466,107916,1939672
84940,4229,2206,0.01084252,0.17,3895117,1586119,359211260,9329174,187377640,7.92E+11,368540434,0.001843228,1.81E-01,345379.7876,1460611122,6.18E+12,5481236,13224291,360797379,17821,30711,48996
35009,9682,18090,0.00041097,0.15,139309,26274117,338957138,175147380,633312810,6.13E+12,514104518,6.16E-05,1.50E-01,39040.88483,377993846.9,3.66E+12,26413426,175286689,365231255,18428,28340,27161
77302,26516,16055,0.02533638,0.005,51934008,2128684,2049739832,425714380,1241083610,3.29E+13,2475454212,0.000126682,3.03E-02,157222.8298,4168920554,1.11E+14,54062692,477648388,2051868516,1309572,156279,1631246
101265,5295,20628,0.00491597,0.03,2635980,3276876,536198175,109225260,2088894420,1.11E+13,645423435,0.000147479,3.49E-02,308068.2691,1631221485,8.64E+12,5912856,111861240,539475051,112734,97138,339073
75134,12373,2399,0.00056263,0.13,523066,3859369,929632982,29682827,180246466,2.23E+12,959315809,7.31E-05,1.31E-01,13183.56899,163120299.1,2.02E+12,4382435,30205893,933492351,4234,11660,10097
29873,90549,11688,0.00082487,0.05,2231312,52919854,2704970277,1058336712,349155624,3.16E+13,3763306989,4.12E-05,5.08E-02,14400.39998,1303941818,1.18E+14,55151166,1060568024,2757890131,68117,59259,178995
6396,82890,4941,0.00860544,0.17,4562864,69639056,530164440,409559490,31602636,2.62E+12,939723930,0.001462925,1.79E-01,46232.27995,3832193685,3.18E+14,74201920,414122354,599803496,31349,32162,122889
90433,16613,12022,0.00031941,0.17,479903,33954848,1502363429,199721486,1087185526,1.81E+13,1702084915,5.43E-05,1.70E-01,59033.84791,980729315.3,1.63E+13,34434751,200201389,1536318277,31790,75134,52390
65704,32754,5418,0.00041097,0.3,884460,53241882,2152068816,177461172,355984272,1.17E+13,2329529988,0.000123291,3.00E-01,43889.65688,1437561821,4.71E+13,54126342,178345632,2205310698,29828,56699,30479
46498,92174,22576,0.00056263,0.01,2411438,20810150,4285906652,2080920224,1049738848,9.68E+13,6366826876,5.63E-06,1.06E-02,5906.145681,544393072,5.02E+13,23221588,2083331662,4306716802,108724,46109,326058
14088,40146,9306,0.00018467,0.05,104447,18680935,565576848,373598676,131102928,5.26E+12,939175524,9.23E-06,5.02E-02,1210.538886,48598294.1,1.95E+12,18785382,373703123,584257783,6945,4230,11181
132622,40003,6124,0.00160539,0.001,8517214,245012,5305277866,244978372,812177128,3.25E+13,5550256238,1.61E-06,2.61E-03,1303.86104,52158353.16,2.09E+12,8762226,253495586,5305522878,175835,3280,375050
9428,79619,3270,0.01084252,0.17,8139530,44265384,750647932,260354130,30829560,2.45E+12,1011002062,0.001843228,1.81E-01,56825.92055,4524422968,3.60E+14,52404914,268493660,794913316,35959,34246,141460
47833,52281,11377,0.00047003,0.07,1175454,41636774,2500757073,594800937,544196041,2.85E+13,3095558010,3.29E-05,7.05E-02,17905.19256,936101372.3,4.89E+13,42812228,595976391,2542393847,42560,57138,100447
17759,43288,7453,0.00860544,0.05,6615729,16133031,768751592,322625464,132357827,5.73E+12,1091377056,0.000430272,5.86E-02,56949.86694,2465245840,1.07E+14,22748760,329241193,784884623,65941,25215,259192
108906,15711,17154,0.01084252,0.15,18552295,40427531,1711022166,269506494,1868173524,2.94E+13,1980528660,0.001626378,1.61E-01,3038356.32,47735616137,7.50E+14,58979826,288058789,1751449697,844903,676572,2024098
75829,19839,6834,0.00047003,0.23,707123,31187796,1504371531,135579726,518215386,1.03E+13,1639951257,0.000108107,2.30E-01,56022.65891,1111433530,2.21E+13,31894919,136286849,1535559327,16901,56670,33238
132886,46334,10865,0.00041097,0.13,2530438,65450372,6157139924,503418910,1443806390,6.69E+13,6660558834,5.34E-05,1.30E-01,77136.94457,3574063190,1.66E+14,67980810,505949348,6222590296,99769,208418,213491
58668,24638,17499,0.00015297,0.1,221120,43117639,1445462184,431140362,1026631332,2.53E+13,1876602546,1.53E-05,1.00E-01,15704.37949,386924501.8,9.53E+12,43338759,431361482,1488579823,30209,26881,44458
45899,68790,21627,0.00018467,0.03,583089,44633018,3157392210,1487721330,992657673,6.83E+13,4645113540,5.54E-06,3.02E-02,5499.422774,378305292.6,2.60E+13,45216107,1488304419,3202025228,53557,41914,97592
110908,9919,2423,0.00034241,0.17,376693,4086753,1100096452,24033737,268730084,2.67E+12,1124130189,5.82E-05,1.70E-01,15642.69757,155159917.2,1.54E+12,4463446,24410430,1104183205,4567,12555,9649
1848,64745,16631,0.00056263,0.05,67333,53840833,119648760,1076774095,30734088,1.99E+12,1196422855,2.81E-05,5.06E-02,864.5959966,55978267.8,3.63E+12,53908166,1076841428,173489593,12493,4246,19803
88271,43157,2548,0.00860544,0.23,32782779,25300589,3809511547,109964036,224914508,9.71E+12,3919475583,0.001979251,2.39E-01,445162.3099,19211869806,8.29E+14,58083368,142746815,3834812136,183288,182443,494181
110773,70145,9952,0.00013363,0.01,1038344,6981359,7770172085,698083040,1102412896,7.73E+13,8468255125,1.34E-06,1.01E-02,1473.154353,103334412.1,7.25E+12,8019703,699121384,7777153444,34606,10493,92557
80589,17498,3604,0.00082487,0.1,1163260,6306695,1410146322,63062792,290442756,5.08E+12,1473209114,8.25E-05,1.01E-01,23957.75161,419212737.7,7.34E+12,7469955,64226052,1416453017,10013,25353,29122
60033,5445,19816,0.01084252,0.1,3544630,10791564,326879685,107898120,1189613928,6.48E+12,434777805,0.001084252,1.11E-01,1289841.281,7023185773,3.83E+13,14336194,111442750,337671249,111165,160081,379537
120839,50527,8780,0.00860544,0.07,52542048,31057297,6105632153,443627060,1060966420,5.36E+13,6549259213,0.000602381,7.86E-02,639105.8009,32292098800,1.63E+15,83599345,496169108,6136689450,1393595,461181,3114824
47657,37735,34926,0.02533638,0.05,45564267,65898346,1798336895,1317932610,1664468382,6.28E+13,3116269505,0.001266819,7.53E-02,2108580.171,79567272761,3.00E+15,111462613,1363496877,1864235241,2443637,705458,8334521
114591,3158,7411,0.00034241,0.2,123935,4682145,361878378,23403938,849233901,2.68E+12,385282316,6.85E-05,2.00E-01,58157.23601,183660551.3,5.80E+11,4806080,23527873,366560523,8646,13073,15212
147238,54911,7528,0.00296184,0.005,23946767,2067108,8084985818,413370008,1108407664,6.09E+13,8498355826,1.48E-05,7.96E-03,16414.63078,901343790.6,4.95E+13,26013875,437316775,8087052926,676385,69058,1307578
65896,58582,31178,0.00041097,0.01,1586481,18265074,3860319472,1826469596,2054505488,1.20E+14,5686789068,4.11E-06,1.04E-02,8443.401204,494631329.3,2.90E+13,19851555,1828056077,3878584546,103810,43071,317329
27913,2456,40722,0.00082185,0.3,56347,30007520,68554328,100013232,1136673186,2.79E+12,168567560,0.000246555,3.01E-01,280252.4574,688300035.3,1.69E+12,30063867,100069579,98561848,18590,41676,28206
51879,20800,7173,0.00082487,0.17,890141,25365116,1079083200,149198400,372128067,7.74E+12,1228281600,0.000140228,1.71E-01,52182.73737,1085400937,2.26E+13,26255257,150088541,1104448316,18396,47865,39058
82569,34669,1964,0.00160539,0.07,4595645,4767716,2862584661,68089916,162165516,5.62E+12,2930674577,0.000112377,7.16E-02,18223.72284,631798247.2,2.19E+13,9363361,72685561,2867352377,22599,24767,55189
26689,24945,10348,0.00082282,0.13,547816,33558389,665757105,258130860,276177772,6.89E+12,923887965,0.000106967,1.31E-01,29541.79727,736920132.8,1.84E+13,34106205,258678676,699315494,10804,33941,35540
69007,15791,15563,0.00047003,0.01,512212,2457758,1089689537,245755333,1073955941,1.70E+13,1335444870,4.70E-06,1.05E-02,5047.915109,79711627.49,1.26E+12,2969970,246267545,1092147295,21593,6432,57888
126844,9195,7845,0.00860544,0.23,10037895,16593706,1166330580,72134775,995091180,9.15E+12,1238465355,0.001979251,2.39E-01,1969535.412,18109878114,1.67E+14,26631601,82172670,1182924286,235619,275244,539254
97040,37392,8669,0.00031941,0.13,1159001,42140629,3628519680,324151248,841239760,3.15E+13,3952670928,4.15E-05,1.30E-01,34931.05093,1306141856,4.88E+13,43299630,325310249,3670660309,37409,82931,74126
99035,1713,8476,0.00370564,0.01,628689,145215,169646955,14519388,839420660,1.44E+12,184166343,3.71E-05,1.37E-02,31105.90775,53284419.97,91295073135,773904,15148077,169792170,15490,3000,39826
47609,17518,6995,0.00018467,0.15,154020,18381625,834014462,122538410,333024955,5.83E+12,956552872,2.77E-05,1.50E-01,9224.957766,161602810.1,2.83E+12,18535645,122692430,852396087,9894,10680,15336
15716,2209,30840,0.00491597,0.23,170693,15671446,34716644,68125560,484681440,1.07E+12,102842204,0.001130673,2.35E-01,548016.2663,1210567932,2.68E+12,15842139,68296253,50388090,12087,49719,31245
90031,42915,12382,0.00860544,5.00E-04,33249145,265703,3863680365,531373530,1114763842,4.78E+13,4395053895,4.30E-06,9.11E-03,4796.516678,205842513.2,8.83E+12,33514848,564622675,3863946068,938475,18425,2415754
92784,3657,10555,0.00491597,0.07,1668300,2702430,339311088,38599635,979335120,3.58E+12,377910723,0.000344118,7.49E-02,337006.7449,1232433666,4.51E+12,4370730,40267935,342013518,36429,69169,110946
72808,7536,17654,0.00160539,0.01,880926,1330565,548681088,133040544,1285352432,9.69E+12,681721632,1.61E-05,1.16E-02,20634.91941,155504752.7,1.17E+12,2211491,133921470,550011653,33094,11742,98161
49206,24341,33758,0.00082185,0.07,984397,57522333,1197723246,821703478,1661096148,4.04E+13,2019426724,5.75E-05,7.08E-02,95562.03085,2326075393,5.66E+13,58506730,822687875,1255245579,79051,153299,215862
48234,38463,11680,0.00491597,0.15,9120364,67391809,1855224342,449247840,563373120,2.17E+13,2304472182,0.000737396,1.55E-01,415428.8035,15978638069,6.15E+14,76512173,458368204,1922616151,167870,185310,567868
29071,47644,32600,0.00019487,0.005,269912,7766110,1385058724,1553194400,947714600,4.52E+13,2938253124,9.74E-07,5.19E-03,923.4057205,43994742.15,2.10E+12,8036022,1553464312,1392824834,42208,3136,63568
70405,70789,18242,0.00491597,0.01,24501130,12913979,4983899545,1291332938,1284328010,9.09E+13,6275232483,4.92E-05,1.49E-02,63137.17967,4469417812,3.16E+14,37415109,1315834068,4996813524,754033,173860,2423968
15945,4543,23783,0.01084252,0.17,785460,18368965,72438135,108046169,379219935,1.72E+12,180484304,0.001843228,1.81E-01,698988.954,3175506818,1.44E+13,19154425,108831629,90807100,27496,54377,106741
108206,17348,17904,1.65E-05,0.15,30993,46592178,1877157688,310598592,1937320224,3.36E+13,2187756280,2.48E-06,1.50E-01,4797.773535,83231775.28,1.44E+12,46623171,310629585,1923749866,32045,7177,30245
149626,45170,4273,0.00056263,0.01,3802617,1930446,6758606420,193011410,639351898,2.89E+13,6951617830,5.63E-06,1.06E-02,3597.185584,162484872.8,7.34E+12,5733063,196814027,6760536866,59326,15209,124990
47984,11376,32542,0.00018467,0.15,100812,55533733,545865984,370197792,1561495328,1.78E+13,916063776,2.77E-05,1.50E-01,43254.20133,492059794.4,5.60E+12,55634545,370298604,601399717,43254,52002,46086
57185,54797,7778,8.43E-05,0.05,264131,21313253,3133566445,426211066,444784930,2.44E+13,3559777511,4.21E-06,5.01E-02,1874.546087,102719502,5.63E+12,21577384,426475197,3154879698,18117,8250,28520
108780,87037,3489,0.00078778,0.005,7458617,1518731,9467884860,303672093,379533420,3.30E+13,9771556953,3.94E-06,5.79E-03,1494.944188,130115457.3,1.13E+13,8977348,311130710,9469403591,77276,13113,183227
42134,16316,15230,0.00078778,0.2,541575,49701570,687458344,248492680,641700820,1.05E+13,935951024,0.000157556,2.01E-01,101103.8144,1649609836,2.69E+13,50243145,249034255,737159914,25530,73870,52831
108694,4562,8293,0.00182521,0.1,905216,3784246,495862028,37832666,901399342,4.11E+12,533694694,0.000182521,1.02E-01,164524.3093,750559899,3.43E+12,4689462,38737882,499646274,19948,48441,54430
73775,21308,10383,0.00108175,0.15,1700523,33188048,1571997700,221240964,766005825,1.63E+13,1793238664,0.000162263,1.51E-01,124294.0202,2648456982,5.64E+13,34888571,222941487,1605185748,37852,116107,105876
134344,70936,12491,0.00370564,0.03,35314202,26582231,9529825984,886061576,1678090904,1.19E+14,10415887560,0.000111169,3.37E-02,186552.0233,13233254327,9.39E+14,61896433,921375778,9556408215,1552728,337141,3174760
131168,42895,2656,0.00108175,0.07,6086553,7977656,5626451360,113929120,348382208,1.49E+13,5740380480,7.57E-05,7.11E-02,26380.37175,1131586046,4.86E+13,14064209,120015673,5634429016,58246,48953,126187
37091,39964,23441,0.00160539,0.05,2379772,46842246,1482304724,936796124,869450131,3.47E+13,2419100848,8.03E-05,5.16E-02,69790.32729,2789100640,1.11E+14,49222018,939175896,1529146970,98055,122772,326827
94025,48230,6778,0.00082185,0.17,3727057,55580602,4534825750,326902940,637301450,3.07E+13,4861728690,0.000139715,1.71E-01,89040.25344,4294411423,2.07E+14,59307659,330629997,4590406352,85333,118636,164722
64727,24398,9444,0.00041097,0.3,649017,69131561,1579209346,230414712,611281788,1.49E+13,1809624058,0.000123291,3.00E-01,75365.54292,1838768516,4.49E+13,69780578,231063729,1648340907,46482,71921,41937
39133,73689,1855,0.00013363,0.23,385354,31451652,2883671637,136693095,72591715,5.35E+12,3020364732,3.07E-05,2.30E-01,2231.099101,164407461.7,1.21E+13,31837006,137078449,2915123289,3181,7725,6501
121529,30410,5983,0.00370564,0.23,13695378,41849822,3695696890,181943030,727108007,2.21E+13,3877639920,0.000852297,2.34E-01,619712.1185,18845445522,5.73E+14,55545200,195638408,3737546712,267728,285551,561753
61415,6437,15333,0.00860544,0.25,3402262,24677007,395328355,98698521,941676195,6.06E+12,494026876,0.00215136,2.59E-01,2025884.499,13040618519,8.40E+13,28079269,102100783,420005362,89064,181503,283926
55830,57401,36756,0.00018467,0.01,591827,21098951,3204697830,2109831156,2052087480,1.18E+14,5314528986,1.85E-06,1.02E-02,3789.589949,217526252.7,1.25E+13,21690778,2110422983,3225796781,74679,20522,174433
127514,19452,15773,1.65E-05,0.13,40953,39889860,2480402328,306816396,2011278322,3.91E+13,2787218724,2.15E-06,1.30E-01,4316.806663,83970523.2,1.63E+12,39930813,306857349,2520292188,31441,6940,30612
54878,11686,33633,0.00019487,0.07,124976,27514033,641304308,393035238,1845711774,2.16E+13,1034339546,1.36E-05,7.02E-02,25177.16974,294220405.6,3.44E+12,27639009,393160214,668818341,31880,27021,51036
21847,12959,27956,0.00160539,0.13,454553,47099860,283115273,362281804,610754732,7.91E+12,645397077,0.000208701,1.32E-01,127464.9401,1651818159,2.14E+13,47554413,362736357,330215133,30363,81903,76321
102049,59862,757,0.00860544,0.3,52569961,13603705,6108857238,45315534,77251093,4.62E+12,6154172772,0.002581632,3.09E-01,199433.8937,11938511746,7.15E+14,66173666,97885495,6122460943,102311,105282,238673
122009,43256,15992,0.00056263,0.001,2969398,691785,5277621304,691749952,1951167928,8.44E+13,5969371256,5.63E-07,1.56E-03,1097.785611,47485814.4,2.05E+12,3661183,694719350,5278313089,137736,3010,353844
7477,74246,8160,0.00056263,0.1,312379,60586863,555137342,605847360,61012320,4.53E+12,1160984702,5.63E-05,1.01E-01,3432.73616,254866928.9,1.89E+13,60899242,606159739,615724205,11437,8585,22849
3304,87024,2203,0.00370564,0.13,1065607,24929437,287527296,191713872,7278712,6.33E+11,479241168,0.000481733,1.34E-01,3506.397224,305140712,2.66E+13,25995044,192779479,312456733,5461,3806,15866
129561,4065,5094,0.00013363,0.2,70381,4141777,526665465,20707110,659983734,2.68E+12,547372575,2.67E-05,2.00E-01,17638.72527,71701418.24,2.92E+11,4212158,20777491,530807242,6645,4661,9750
52997,59347,18456,0.00163948,0.005,5156583,5476661,3145212959,1095308232,978112632,5.80E+13,4240521191,8.20E-06,6.64E-03,8017.98049,475843088.1,2.82E+13,10633244,1100464815,3150689620,157879,34037,512186
39809,16387,8566,0.00182521,0.07,1190744,9826828,652350083,140371042,341003894,5.59E+12,792721125,0.000127765,7.18E-02,43568.26022,713953080.2,1.17E+13,11017572,141561786,662176911,17921,33282,61166
22403,63795,26881,0.00082487,0.03,1178949,51448535,1429199385,1714873395,602215043,3.84E+13,3144072780,2.47E-05,3.08E-02,14902.47368,950703308.1,6.07E+13,52627484,1716052344,1480647920,57816,57760,212506
24576,25126,48683,8.43E-05,0.05,52051,61162927,617496576,1223209058,1196433408,3.01E+13,1840705634,4.21E-06,5.01E-02,5042.368598,126694553.4,3.18E+12,61214978,1223261109,678659503,46382,23141,61331
22084,19077,47798,0.00163948,0.005,690756,4559461,421296468,911842446,1055571032,2.01E+13,1333138914,8.20E-06,6.64E-03,8652.937978,165072097.8,3.15E+12,5250217,912533202,425855929,53955,11610,192023
131957,57529,5698,0.00296184,0.15,22484692,49174524,7591354253,327800242,751890986,4.33E+13,7919154495,0.000444276,1.53E-01,334047.1197,19217396749,1.11E+15,71659216,350284934,7640528777,451091,284663,912849
101773,66197,4228,4.64E-06,0.25,31260,69978179,6737067281,279880916,430296244,2.85E+13,7016948197,1.16E-06,2.50E-01,499.143643,33041811.74,2.19E+12,70009439,279912176,6807045460,4685,3407,28617
104640,11798,5374,0.00082282,0.01,1015889,634117,1234542720,63402452,562335360,6.63E+12,1297945172,8.23E-06,1.08E-02,4627.007809,54589438.13,6.44E+11,1650006,64418341,1235176837,14449,3600,40014
139418,13043,14408,0.00108175,0.27,1967151,50741036,1818428974,187923544,2008734544,2.62E+13,2006352518,0.000292073,2.71E-01,586696.1201,7652277494,9.98E+13,52708187,189890695,1869170010,92645,285744,208857
73266,19537,13652,0.00082185,0.23,1176437,61349870,1431397842,266719124,1000227432,1.95E+13,1698116966,0.000189026,2.31E-01,189068.4904,3693831098,7.22E+13,62526307,267895561,1492747712,52874,147765,97754
126406,52269,6702,0.00047003,0.17,3105554,59560352,6607115214,350306838,847173012,4.43E+13,6957422052,7.99E-05,1.70E-01,67693.44424,3538268637,1.85E+14,62665906,353412392,6666675566,79255,145200,155580
59911,37530,20157,1.65E-05,0.07,37122,52955082,2248459830,756492210,1207626027,4.53E+13,3004952040,1.16E-06,7.00E-02,1395.653399,52378872.08,1.97E+12,52992204,756529332,2301414912,35805,4958,45493
70938,6237,4544,0.00013363,0.23,59130,6519541,442440306,28340928,322342272,2.01E+12,470781234,3.07E-05,2.30E-01,9907.157496,61790941.3,3.86E+11,6578671,28400058,448959847,4125,4115,6244
127148,16270,4320,0.00108175,0.2,2237850,14058140,2068697960,70286400,549279360,8.94E+12,2138984360,0.00021635,2.01E-01,118836.5895,1933471312,3.15E+13,16295990,72524250,2082756100,26738,77931,68895
105338,18403,7308,2.09E-05,0.25,40477,33625627,1938535214,134489124,769810104,1.42E+13,2073024338,5.22E-06,2.50E-01,4018.408743,73950776.1,1.36E+12,33666104,134529601,1972160841,19112,5371,20153
117448,25664,11411,1.65E-05,0.23,49765,67357941,3014185472,292851904,1340199128,3.44E+13,3307037376,3.80E-06,2.30E-01,5089.138149,130607641.4,3.35E+12,67407706,292901669,3081543413,38105,10190,31805
8770,83468,22375,0.00952101,0.001,6969995,1867678,732014360,1867596500,196228750,1.64E+13,2599610860,9.52E-06,1.05E-02,1868.295891,155942921.4,1.30E+13,8837673,1874566495,733882038,209253,10412,816333
140433,42083,8565,0.00860544,0.13,50857044,46859173,5909841939,360440895,1202808645,5.06E+13,6270282834,0.001118707,1.39E-01,1345590.691,56626493066,2.38E+15,97716217,411297939,5956701112,1424733,687641,2999027
60333,88658,1913,0.00041097,0.27,2198308,45797142,5349003114,169602754,115417029,1.02E+13,5518605868,0.000110962,2.70E-01,12806.89283,1135433505,1.01E+14,47995450,171801062,5394800256,7878,20852,26344
58182,38661,6290,0.00019487,0.15,438343,36481471,2249374302,243177690,365964780,1.41E+13,2492551992,2.92E-05,1.50E-01,10697.3335,413569610.5,1.60E+13,36919814,243616033,2285855773,22487,31320,21228
108087,12610,3734,0.00041097,0.3,560157,14129721,1362977070,47085740,403596858,5.09E+12,1410062810,0.000123291,3.00E-01,49759.86022,627471837.4,7.91E+12,14689878,47645897,1377106791,9354,35120,22541
138847,26064,5323,0.00078778,0.03,2850930,4162554,3618908208,138738672,739082581,1.93E+13,3757646880,2.36E-05,3.08E-02,17467.03427,455260781.2,1.19E+13,7013484,141589602,3623070762,46113,34498,116383
100883,19361,2857,0.00041097,0.27,802715,14939784,1953195763,55314377,288222731,5.58E+12,2008510140,0.000110962,2.70E-01,31981.74185,619198504.1,1.20E+13,15742499,56117092,1968135547,8761,33885,17456
90314,79836,19085,0.00082185,0.03,5925899,45711071,7210308504,1523670060,1723642690,1.38E+14,8733978564,2.47E-05,3.08E-02,42497.27234,3392812235,2.71E+14,51636970,1529595959,7256019575,278657,206115,730775
70094,61867,23852,0.00182521,0.005,7915102,7378372,4336505498,1475651684,1671882088,1.03E+14,5812157182,9.13E-06,6.83E-03,15257.67953,943946859.4,5.84E+13,15293474,1483566786,4343883870,317594,69313,1028615
113424,5936,9464,0.00082282,0.13,554023,7304292,673284864,56178304,1073444736,6.37E+12,729463168,0.000106967,1.31E-01,114822.7337,681587747.2,4.05E+12,7858315,56732327,680589156,18685,45741,43630
102978,88696,1633,2.48E-05,0.25,226792,36225958,9133736688,144840568,168163074,1.49E+13,9278577256,6.21E-06,2.50E-01,1043.872282,92587295.91,8.22E+12,36452750,145067360,9169962646,3404,7365,5520
112053,84912,15214,0.00078778,0.005,7495561,6459476,9514644336,1291851168,1704774342,1.45E+14,10806495504,3.94E-06,5.79E-03,6714.935656,570178616.4,4.84E+13,13955037,1299346729,9521103812,331366,45948,793643
104040,52796,11297,1.65E-05,0.1,90689,59646665,5492895840,596436412,1175339880,6.21E+13,6089332252,1.65E-06,1.00E-01,1940.486142,102449906.3,5.41E+12,59737354,596527101,5552542505,40079,9198,34151
143145,6771,14880,0.00013363,0.25,129536,25192654,969234795,100752480,2129997600,1.44E+13,1069987275,3.34E-05,2.50E-01,71157.89482,481810105.8,3.26E+12,25322190,100882016,994427449,27596,39018,39361
85454,49826,824,0.00047003,0.07,2001331,2875681,4257831004,41056624,70414096,3.51E+12,4298887628,3.29E-05,7.05E-02,2316.771628,115435463.1,5.76E+12,4877012,43057955,4260706685,3432,6517,11521
73228,31311,712,0.00182521,0.03,4184969,669062,2292841908,22293432,52138336,1.63E+12,2315135340,5.48E-05,3.18E-02,2854.902368,89389848.03,2.80E+12,4854031,26478401,2293510970,5549,4353,17587
27990,14511,16266,0.00163948,0.13,665920,30686207,406162890,236035926,455285340,6.61E+12,642198816,0.000213132,1.32E-01,97036.0572,1408090226,2.04E+13,31352127,236701846,436849097,28554,55084,62377
63926,58698,21431,0.00047003,0.03,1763726,37740518,3752328348,1257956838,1369998106,8.04E+13,5010285186,1.41E-05,3.05E-02,19318.20629,1133940073,6.66E+13,39504244,1259720564,3790068866,86094,101397,245909
88263,89988,2534,0.00078778,0.23,6257109,52448941,7942610844,228029592,223658442,2.01E+13,8170640436,0.000181189,2.31E-01,40524.53891,3646722208,3.28E+14,58706050,234286701,7995059785,58639,59596,111238
127492,67894,8994,0.00019487,0.07,1686812,42746615,8655941848,610638636,1146663048,7.79E+13,9266580484,1.36E-05,7.02E-02,15641.51597,1061965085,7.21E+13,44433427,612325448,8698688463,58923,86096,148601
44037,46903,4576,0.00034241,0.23,707257,49369804,2065467411,214628128,201513312,9.45E+12,2280095539,7.88E-05,2.30E-01,15870.03983,744352478,3.49E+13,50077061,215335385,2114837215,25689,24740,31645
116957,18109,5848,0.00491597,0.15,10412286,15887125,2117974313,105901432,683964536,1.24E+13,2223875745,0.000737396,1.55E-01,504352.371,9133317087,1.65E+14,26299411,116313718,2133861438,181132,164020,392604
117129,37728,9504,8.43E-05,0.1,372484,35857637,4419042912,358566912,1113194016,4.20E+13,4777609824,8.43E-06,1.00E-01,9383.112361,354006063.2,1.34E+13,36230121,358939396,4454900549,31138,34186,29814
54745,18215,8454,0.00163948,0.3,1634891,46202415,997180175,153989610,462814230,8.43E+12,1151169785,0.000491844,3.02E-01,227632.4021,4146324205,7.55E+13,47837306,155624501,1043382590,37951,80632,76469
88155,79258,19942,0.00018467,0.005,1290299,7903096,6986988990,1580563036,1757987010,1.39E+14,8567552026,9.23E-07,5.18E-03,1623.237306,128654542.4,1.02E+13,9193395,1581853335,6994892086,71163,14398,198703
58500,72396,2366,0.00491597,0.3,20820430,51394195,4235166000,171288936,138411000,1.00E+13,4406454936,0.001474791,3.05E-01,204127.2971,14777999801,1.07E+15,72214625,192109366,4286560195,77516,113845,259288
78441,27920,14057,0.00952101,0.13,20851937,51025114,2190072720,392471440,1102645137,3.08E+13,2582544160,0.001237731,1.40E-01,1364778.399,38104612896,1.06E+15,71877051,413323377,2241097834,520580,434655,1572873
136233,91496,888,0.00082185,0.05,10244319,4062949,12464774568,81248448,120974904,1.11E+13,12546023016,4.11E-05,5.08E-02,4971.161243,454841369.1,4.16E+13,14307268,91492767,12468837517,35740,18203,71834
134040,9258,2760,0.00491597,0.01,6100521,255554,1240942320,25552080,369950400,3.43E+12,1266494400,4.92E-05,1.49E-02,18186.65068,168372012,1.56E+12,6356075,31652601,1241197874,57039,12710,121570
94741,3356,15316,0.00491597,0.15,1563061,7710242,317950796,51400496,1451053156,4.87E+12,369351292,0.000737396,1.55E-01,1070000.067,3590920227,1.21E+13,9273303,52963557,325661038,53350,149334,151154
25845,6614,29098,0.01084252,0.2,1853575,38494486,170938830,192454172,752037810,4.97E+12,363393002,0.002168504,2.11E-01,1630796.999,10786091352,7.14E+13,40348061,194307747,209433316,78693,146114,280707
94177,8312,10788,0.00031941,0.25,250056,22421007,782799224,89669856,1015981476,8.44E+12,872469080,7.99E-05,2.50E-01,81128.66081,674341428.7,5.61E+12,22671063,89919912,805220231,19914,56150,17318
147930,31432,996,0.00031941,0.07,1485205,2193518,4649735760,31306272,147338280,4.63E+12,4681042032,2.24E-05,7.03E-02,3294.292401,103546198.7,3.26E+12,3678723,32791477,4651929278,5399,9109,13536
27831,11270,20174,0.00013363,0.25,41916,56843668,313655370,227360980,561462594,6.33E+12,541016350,3.34E-05,2.50E-01,18757.06161,253670501.2,2.38E+12,56885584,227402896,370499038,28221,14062,22875
14181,94003,1950,0.00082185,0.3,1095598,54996768,1333056543,183305850,27652950,2.60E+12,1516362393,0.000247,3.01E-01,6817.973087,1068183.207,6.03E+13,56092366,184401448,1388053311,4715,7090,13693
132956,16755,3248,0.00031941,0.25,711549,13608396,2227677780,54420240,431841088,7.24E+12,2282098020,7.99E-05,2.50E-01,34483.59048,300441730.4,9.68E+12,14319945,55131789,2241286176,10312,35612,25238
112343,34138,7278,0.00018467,0.13,708256,32302311,3835165334,248456364,817632354,2.79E+13,4083621698,2.40E-05,1.30E-01,19628.98169,360819941.3,2.29E+13,33010567,249164620,3867467645,28430,57191,54479
66045,72263,22300,0.00952101,0.03,45441030,48344875,4772609835,1611464900,1472803500,1.06E+14,6384074735,0.000286,3.95E-02,420677.3055,2.53E+11,2.20E+15,93785905,1656905930,4820954710,1635212,417179,5305070
130857,38012,1280,0.00041097,0.25,2044271,12169032,4974136284,48655360,167496960,6.37E+12,5022791644,0.000103,2.50E-01,17209.05641,706482704.6,2.49E+13,14213303,50699631,4986305316,6816,26338,19876
97578,7459,14889,0.00019487,0.27,141843,29989369,727834302,111057051,1452838842,1.08E+13,838891353,5.26E-05,2.70E-01,76440.97039,2111752.586,4.25E+12,30131212,111198894,757823671,25293,48811,33065
65530,62105,28142,0.00860544,5.00E-04,35022554,873915,4069740650,1747758910,1844145260,1.15E+14,5817499560,4.30E-06,9.11E-03,7934.840693,2.27E+11,3.06E+13,35896469,1782781464,4070614565,1584164,32961,5131248
40714,7000,38892,0.00952101,0.23,2713741,62621498,284998000,272244000,1583448888,1.11E+13,557242000,0.00219,2.40E-01,3467487.52,3165966866,1.70E+14,65335239,274957741,347619498,166623,318140,551015
8350,12002,37253,0.00047003,0.03,47106,13413859,100216700,447110506,311062550,3.73E+12,547327206,1.41E-05,3.05E-02,4386.261911,526439154.6,6.32E+11,13460965,447157612,113630559,9872,3295,20759
64938,6886,22246,0.00078778,0.3,352280,45958453,447163068,153185956,1444610748,9.95E+12,600349024,0.000236,3.01E-01,341410.6365,1567302429,1.62E+13,46310733,153538236,493121521,37054,137086,56787
143715,65429,4334,0.00078778,0.07,7407700,19850498,9403128735,283569286,622860810,4.08E+13,9686698021,5.51E-05,7.08E-02,34347.41022,8026131084,1.47E+14,27258198,290976986,9422979233,123781,100669,242419
125421,32313,6175,0.00952101,0.25,38587041,49890216,4052728773,199532775,774474675,2.50E+13,4252261548,0.00238,2.60E-01,1843445.281,1191344948,1.93E+15,88477257,238119816,4102618989,727242,639584,1576516
72613,89253,20566,0.00013363,0.03,866057,55067736,6480928089,1835577198,1493358958,1.33E+14,8316505287,4.01E-06,3.01E-02,5986.726727,534333320.5,4.77E+13,55933793,1836443255,6535995825,75279,52607,157363
13520,47932,33230,0.00041097,0.03,266335,47784808,648040640,1592780360,449269600,2.15E+13,2240821000,1.23E-05,3.04E-02,5539.089825,2212497113,1.27E+13,48051143,1593046695,695825448,34661,18652,70633
109483,27731,8396,0.00108175,0.25,3284344,58210082,3036073073,232829476,919219268,2.55E+13,3268902549,0.00027,2.51E-01,248591.3608,1378737405,1.91E+14,61494426,236113820,3094283155,79609,186229,187908
110414,25191,4853,0.00082487,0.05,2294423,6113663,2781439074,122251923,535839142,1.35E+13,2903690997,4.12E-05,5.08E-02,22099.88165,55671811.87,1.40E+13,8408086,124546346,2787552737,28895,40085,79112
49178,98112,2452,0.00952101,0.15,45938885,36100542,4824951936,240570624,120584456,1.18E+13,5065522560,0.00143,1.60E-01,172212.8717,5632049757,1.66E+15,82039427,286509509,4861052478,174422,123826,575573
127672,23870,16304,0.00082487,0.05,2513848,19459838,3047530640,389176480,2081564288,4.97E+13,3436707120,4.12E-05,5.08E-02,85850.99671,2049263292,4.89E+13,21973686,391690328,3066990478,117170,145855,302847
65650,61885,8058,0.00163948,0.1,6660921,49869856,4062750250,498669330,529007700,3.27E+13,4561419580,0.000164,1.02E-01,86729.7544,12344722957,3.32E+14,56530777,505330251,4112620106,89321,111475,291083
130155,25044,3545,0.00296184,0.23,9654607,20422157,3259601820,88780980,461399475,1.16E+13,3348382800,0.000681,2.33E-01,314316.0268,34224915.55,1.97E+14,30076764,98435587,3280023977,115774,124011,242351
106017,58524,10918,0.00163948,0.01,10172324,6389896,6204538908,638965032,1157493606,6.77E+13,6843503940,1.64E-05,1.16E-02,18976.87617,16659040516,6.50E+13,16562220,649137356,6210928804,302300,80166,730944
61442,21298,6466,0.00491597,0.15,6433115,20658683,1308591716,137712868,397283972,8.46E+12,1446304584,0.000737,1.55E-01,292955.4132,5407449138,1.33E+14,27091798,144145983,1329250399,75710,92795,219216
27923,24266,6672,0.02533638,0.13,17167950,21050689,677579518,161902752,186302256,4.52E+12,839482270,0.00329,1.55E-01,613629.2179,8017868170,3.61E+14,38218639,179070702,698630207,164867,105441,584790
76769,43145,12086,0.00082282,0.005,2725427,2607392,3312198505,521450470,927830134,4.00E+13,3833648975,4.11E-06,5.82E-03,3817.185954,8234624400,7.11E+12,5332819,524175897,3314805897,61985,12244,195135
27107,22534,3468,0.00160539,0.25,980679,19542021,610829138,78147912,94007076,2.12E+12,688977050,0.000401,2.52E-01,37729.50493,442102265.4,1.92E+13,20522700,79128591,630371159,5375,17138,19112
45399,74397,4100,0.00078778,0.03,2660812,9151729,3377549403,305027700,186135900,1.38E+13,3682577103,2.36E-05,3.08E-02,4399.024179,763639804.3,2.44E+13,11812541,307688512,3386701132,17692,19591,61842
118916,18104,2542,0.00182521,0.07,3929504,3222456,2152855264,46020368,302284472,5.47E+12,2198875632,0.000128,7.18E-02,38621.28488,9988567.735,1.27E+13,7151960,49949872,2156077720,29670,34345,72358
90165,40716,4848,0.00082185,0.01,3017247,1974257,3671158140,197391168,437119920,1.78E+13,3868549308,8.22E-06,1.08E-02,3592.470063,2486607188,5.96E+12,4991504,200408415,3673132397,34232,11979,94180
73304,99311,3386,0.00182521,0.17,13287523,57169824,7279893544,336267046,248207344,2.46E+13,7616160590,0.00031,1.72E-01,77015.18948,13497274380,7.60E+14,70457347,349554569,7337063368,77322,101664,264035
138837,34229,4344,0.00056263,0.15,2673820,22304505,4752251673,148690776,603107928,2.06E+13,4900942449,8.44E-05,1.51E-01,50898.99203,116148106.5,5.96E+13,24978325,151364596,4774556178,43025,85631,87520
140022,20920,8204,0.00041097,0.01,1203880,1716520,2929260240,171627680,1148740488,2.40E+13,3100887920,4.11E-06,1.04E-02,4720.978784,987628761.5,2.07E+12,2920400,172831560,2930976760,29122,8591,82359
77953,50154,8559,8.43E-05,0.07,329548,30050452,3909654762,429268086,667199727,3.35E+13,4338922848,5.90E-06,7.01E-02,3936.678549,14102869.71,9.90E+12,30380000,429597634,3939705214,24871,15050,31883
143588,89825,2074,0.00491597,0.005,63405986,931889,12897792100,186297050,297801512,2.68E+13,13084089150,2.46E-05,9.92E-03,7319.916495,39450689948,5.91E+13,64337875,249703036,12898723989,470112,30679,927863
9248,74241,2490,0.00082282,0.3,564959,55459901,686580768,184860090,23027520,1.71E+12,871440858,0.000247,3.01E-01,5684.251202,14066816.45,3.13E+13,56024860,185425049,742040669,4115,5242,10196
20666,25145,23153,0.00860544,0.01,4472056,5822011,519646570,582182185,478479898,1.20E+13,1101828755,8.61E-05,1.86E-02,41175.30053,27954529162,2.60E+13,10294067,586654241,525468581,145501,46815,547757
72243,8821,22229,0.01084252,0.001,6910233,196108,637255503,196082009,1605889647,1.42E+13,833337512,1.08E-05,1.18E-02,17411.89062,4607708614,1.36E+12,7106341,202992242,637451611,250044,8203,831624
68869,43751,24764,0.00182521,0.05,5499641,54173542,3013087619,1083449764,1705471916,7.46E+13,4096537383,9.13E-05,5.18E-02,155642.2198,36771314893,2.98E+14,59673183,1088949405,3067261161,253877,254077,780515
132468,39822,5474,0.00296184,0.27,15624586,58864173,5275140696,217985628,725129832,2.89E+13,5493126324,8.00E-04,2.73E-01,579884.0062,427632238.8,9.20E+14,74488759,233610214,5334004869,310418,313676,612468
124253,15941,10069,0.00370564,0.005,7339901,802621,1980717073,160509929,1251103457,1.99E+13,2141227002,1.85E-05,8.71E-03,23180.69507,739046920.3,5.89E+12,8142522,167849830,1981519694,229281,24079,514123
139109,57172,12205,0.00182521,0.01,14516324,6978087,7953139748,697784260,1697825345,9.71E+13,8650924008,1.83E-05,1.18E-02,30988.87798,47835795560,1.01E+14,21494411,712300584,7960117835,641569,123403,1289992
137785,23975,5092,0.00041097,0.17,1357622,20756460,3303395375,122080700,701601220,1.68E+13,3425476075,6.99E-05,1.70E-01,49017.29908,1382576171,2.82E+13,22114082,123438322,3324151835,26366,77693,55999
98102,9855,18385,0.00082487,0.15,797487,27178236,966795210,181184175,1803605270,1.78E+13,1147979385,0.000124,1.51E-01,223160.9819,2492485006,2.17E+13,27975723,181981662,993973446,48200,139106,108364
142461,91542,402,0.00031941,0.17,4165506,6261831,13041164862,36799884,57269322,5.24E+12,13077964746,5.43E-05,1.70E-01,3109.707004,8372611.722,2.61E+13,10427337,40965390,13047426693,5565,9505,13455
16210,68835,2051,0.00370564,0.27,4135025,38122223,1115815350,141180585,33246710,2.29E+12,1256995935,0.001,2.74E-01,33264.09138,1272074295,1.58E+14,42257248,145315610,1153937573,12397,18488,46284
10495,49421,14298,0.00019487,0.05,101079,35333773,518673395,706621458,150057510,7.42E+12,1225294853,9.74E-06,5.02E-02,1462.085349,14451544,3.57E+12,35434852,706722537,554007168,11711,5405,17406
113411,71468,12625,0.00108175,0.01,8767995,9023157,8105257348,902283500,1431813875,1.02E+14,9007540848,1.08E-05,1.11E-02,15488.64659,22138851894,7.91E+13,17791152,911051495,8114280505,325418,83155,776619
52776,692,39472,0.00370564,0.2,135396,5465545,36520992,27314624,2083174272,1.44E+12,63835616,0.000741,2.04E-01,1543898.782,2670944.893,7.40E+11,5600941,27450020,41986537,23112,59930,45430
64623,42758,32036,0.00047003,0.01,1298773,13698348,2763150234,1369795288,2070262428,8.85E+13,4132945522,4.70E-06,1.05E-02,9730.85449,1248215629,1.78E+13,14997121,1371094061,2776848582,87174,33847,261976
2916,98568,13881,0.00034241,0.03,98424,41049109,287424288,1368222408,40476996,3.99E+12,1655646696,1.03E-05,3.03E-02,415.791846,95628798.25,4.04E+12,41147533,1368320832,328473397,16151,3288,24539
104934,42084,7304,0.00108175,0.07,4777140,21519148,4416042456,307381536,766437936,3.23E+13,4723423992,7.57E-05,7.11E-02,58036.59661,1046748056,1.03E+14,26296288,312158676,4437561604,100627,105277,230852
27859,71568,8786,0.01084252,0.03,21618774,18864577,1993812912,628796448,244769174,1.75E+13,2622609360,0.000325,4.08E-02,79617.43993,949676823.5,4.08E+14,40483351,650415222,2012677489,288850,62573,984053
62134,45338,14842,0.00860544,0.005,24242237,3364604,2817031292,672906596,922192828,4.18E+13,3489937888,4.30E-05,1.36E-02,39679.37525,71959340601,8.16E+13,27606841,697148833,2820395896,570007,95306,1871710
33424,71646,4555,0.00860544,0.2,20607779,65277259,2394695904,326347530,152246320,1.09E+13,2721043434,0.00172,2.09E-01,262029.3144,23466690324,1.35E+15,85885038,346955309,2459973163,139970,134407,480433
116067,64474,3563,4.64E-06,0.25,34723,57446423,7483303758,229720862,413546721,2.67E+13,7713024620,1.16E-06,2.50E-01,479.7141964,16083128.41,1.99E+12,57481146,229755585,7540750181,27746,3352,17759
63887,44007,2621,0.00182521,0.13,5131567,14995943,2811475209,115342347,167447827,7.37E+12,2926817556,0.000237,1.32E-01,39731.56828,2286457010,7.70E+13,20127510,120473914,2826471152,22936,31717,74006
77383,53619,2936,0.00952101,0.17,39504969,26770049,4149199077,157425384,227196488,1.22E+13,4306624461,0.00162,1.80E-01,367733.8058,3479562165,1.06E+15,66275018,196930353,4175969126,189876,184835,612301
147759,15790,11528,2.48E-05,0.15,57934,27307079,2333114610,182027120,1703365752,2.69E+13,2515141730,3.72E-06,1.50E-01,6344.185743,6678312.859,1.58E+12,27365013,182085054,2360421689,25369,14125,28384
19708,71644,9099,0.00056263,0.01,794435,6519384,1411959952,651888756,179323092,1.28E+13,2063848708,5.63E-06,1.06E-02,1008.925513,216850378.3,5.18E+12,7313819,652683191,1418479336,16814,5081,47497
48616,43004,15007,0.00056263,0.03,1176311,19361941,2090682464,645361028,729580312,3.14E+13,2736043492,1.69E-05,3.06E-02,12314.51313,4060062140,2.28E+13,20538252,646537339,2110044405,40292,38333,110389
53903,22646,2465,0.00108175,0.23,1320497,12841853,1220687338,55822390,132870895,3.01E+12,1276509728,0.000249,2.31E-01,33058.61085,488246935.7,1.70E+13,14162350,57142887,1233529191,5179,18396,19151
58245,62154,7138,0.00296184,0.15,10722484,66553833,3620159730,443655252,415752810,2.58E+13,4063814982,0.000444,1.53E-01,184708.9954,5357521354,7.14E+14,77276317,454377736,3686713563,123187,147935,402815
22788,4329,22360,0.00860544,0.07,848971,6776219,98649252,96796440,509539680,2.21E+12,195445692,0.000602,7.86E-02,306936.9201,18981856.1,5.75E+12,7625190,97645411,105425471,26943,49170,103543
83369,8432,15737,0.00082487,0.05,579869,6634879,702967408,132694384,1311977953,1.11E+13,835661792,4.12E-05,5.08E-02,54110.5627,456260264.7,3.85E+12,7214748,133274253,709602287,26840,34915,67258
43559,97154,3911,0.00034241,0.05,1449090,19000298,4231931086,379969294,170359249,1.66E+13,4611900380,1.71E-05,5.03E-02,2916.635523,396707930.6,2.75E+13,20449388,381418384,4250931384,11779,15900,19965
75330,69317,14236,0.00015297,0.07,798775,69079904,5221649610,986796812,1072397880,7.43E+13,6208446422,1.07E-05,7.02E-02,11483.12926,1137108673,5.52E+13,69878679,987595587,5290729514,57784,85908,112744
57655,7094,36951,0.00160539,0.1,656643,26214366,409004570,262130394,2130409905,1.51E+13,671134964,0.000161,1.02E-01,342013.8757,6065616086,1.72E+13,26871009,262787037,435218936,56556,150642,150547
42546,26011,6910,0.00082487,0.25,912896,44941164,1106664006,179736010,293992860,7.65E+12,1286400016,0.000206,2.51E-01,60626.47261,946173107.4,4.10E+13,45854060,180648906,1151605170,26990,46072,37338
49621,39096,2654,0.00108175,0.13,2098602,13491990,1939982616,103760784,131694134,5.15E+12,2043743400,0.000141,1.31E-01,18519.81683,835443183.2,2.83E+13,15590592,105859386,1953474606,8581,20492,31564
149894,83939,3349,2.09E-05,0.15,262715,42173125,12581952466,281111711,501995006,4.21E+13,12863064177,3.13E-06,1.50E-01,1572.248359,61587378.99,1.11E+13,42435840,281374426,12624125591,8178,20818,21698
101261,76674,7053,0.00082487,0.07,6404431,37860021,7764085914,540781722,714193833,5.48E+13,8304867636,5.77E-05,7.08E-02,41238.19469,451699620,2.42E+14,44264452,547186153,7801945935,132240,126856,299612
26272,16061,39272,0.00491597,0.005,2074408,3153794,421954592,630747592,1031753984,1.66E+13,1052702184,2.46E-05,9.92E-03,25360.35816,5702377975,6.54E+12,5228202,632822000,425108386,106188,25791,431959
143366,63887,14404,0.00041097,0.07,3764191,64419480,9159223642,920228348,2065043864,1.32E+14,10079451990,2.88E-05,7.04E-02,59406.97538,5421904908,2.42E+14,68183671,923992539,9223643122,198046,263358,441517
43664,10966,23723,8.43E-05,0.1,40360,26015373,478819424,260146418,1035841072,1.14E+13,738965842,8.43E-06,1.00E-01,8731.104396,162766994.4,1.05E+12,26055733,260186778,504834797,21093,7046,22790
83751,15647,11715,0.00082487,0.17,1081031,31164699,1310451897,183304605,981142965,1.54E+13,1493756502,0.00014,1.71E-01,137583.6176,6331679.013,3.37E+13,32245730,184385636,1341616596,37855,122775,82446
20331,99012,4343,0.00034241,0.15,689287,64515930,2013012972,430009116,88297533,8.74E+12,2443022088,5.14E-05,1.50E-01,4535.093741,149676233.8,4.45E+13,65205217,430698403,2077528902,9638,12893,22278
71087,17036,17771,0.00163948,0.17,1985491,51467962,1211038132,302746756,1263287077,2.15E+13,1513784888,0.000279,1.72E-01,352092.7625,4586898819,1.02E+14,53453453,304732247,1262506094,76290,199012,200189
10094,11689,34189,0.00163948,0.13,193467,51956723,117988766,399635221,345103766,4.03E+12,517623987,0.000213,1.32E-01,73552.7939,992029162.9,1.01E+13,52150190,399828688,169945489,12777,33990,40147
16342,37914,8110,0.00047003,0.15,291233,46126178,619590588,307482540,132533620,5.02E+12,927073128,7.05E-05,1.50E-01,9344.216611,708553257.2,1.34E+13,46417411,307773773,665716766,7062,13781,17107
26581,81335,3624,0.00013363,0.15,288904,44221787,2161965635,294758040,96329544,7.83E+12,2456723675,2.00E-05,1.50E-01,1930.877545,52349308.37,1.28E+13,44510691,295046944,2206187422,5985,8962,10317
54385,70391,9602,0.00031941,0.05,1222805,33796503,3828214535,675894382,522204770,3.68E+13,4504108917,1.60E-05,5.03E-02,8339.871279,1761155638,4.13E+13,35019308,677117187,3862011038,26081,50256,86500
95359,36124,4189,0.00182521,0.15,6287454,22700993,3444748516,151323436,399458851,1.44E+13,3596071952,0.000274,1.52E-01,109364.4434,7901362308,1.43E+14,28988447,157610890,3467449509,71733,82153,163011
96029,18711,4938,0.00082487,0.01,1482209,924108,1796798619,92394918,474191202,8.87E+12,1889193537,8.25E-06,1.08E-02,3911.460968,36593673.09,1.37E+12,2406317,93877127,1797722727,17296,4905,49788
139342,92144,11953,0.00034241,0.005,4396411,5507387,12839529248,1101397232,1665554926,1.53E+14,13940926480,1.71E-06,5.34E-03,2851.513311,8933494646,2.42E+13,9903798,1105793643,12845036635,183629,22018,416385
98602,24263,16388,8.43E-05,0.17,201654,67597793,2392380326,397622044,1615889576,3.92E+13,2790002370,1.43E-05,1.70E-01,23154.5665,99141043.59,1.36E+13,67799447,397823698,2459978119,46524,54727,66775
11783,40709,16785,0.00182521,0.005,875544,3416569,479674147,683300565,197777655,8.05E+12,1162974712,9.13E-06,6.83E-03,1804.928768,3967749643,2.99E+12,4292113,684176109,483090716,27474,4400,88776
93669,50139,2693,0.00031941,0.27,1500126,36470059,4696469991,135024327,252250617,1.26E+13,4831494318,8.62E-05,2.70E-01,21754.26979,525169826.9,5.47E+13,37970185,136524453,4732940050,23078,42496,28648
43471,518,47963,0.00182521,0.13,41127,3232024,22517978,24844834,2084999573,1.08E+12,47362812,0.000237,1.32E-01,494723.0692,453394665.1,1.33E+11,3273151,24885961,25750002,18353,16026,29672
65767,46761,5435,0.00082185,0.23,2527489,58455009,3075330687,254146035,357443645,1.67E+13,3329476722,0.000189,2.31E-01,67565.96372,68683739.77,1.48E+14,60982498,256673524,3133785696,45489,68300,79392
78454,72212,20005,0.00952101,0.005,53940206,7223352,5665320248,1444601060,1569472270,1.13E+14,7109921308,4.76E-05,1.45E-02,74714.80589,32371833376,3.90E+14,61163558,1498541266,5672543600,1848273,215338,5764831
87163,15153,24472,0.00082282,0.03,1086824,11125399,1320780939,370824216,2133052936,3.23E+13,1691605155,2.47E-05,3.08E-02,52653.5585,3457390612,1.21E+13,12212223,371911040,1331906338,63008,59444,179329
54890,4522,18720,0.00860544,0.13,2136349,11006929,248212580,84651840,1027540800,4.65E+12,332864420,0.00112,1.39E-01,1149517.291,9996379214,2.35E+13,13143278,86788189,259219509,60612,120903,213656
87445,11219,7947,0.00031941,0.25,313379,22293292,981045455,89157393,694925415,7.80E+12,1070202848,7.99E-05,2.50E-01,55491.5317,572754734.6,6.99E+12,22606671,89470772,1003338747,17025,43465,22555
7208,35513,3120,0.00491597,0.23,1258517,25487236,255977704,110800560,22488960,7.99E+11,366778264,0.00113,2.35E-01,25427.66212,1060058228,3.21E+13,26745753,112059077,281464940,5478,6403,21758
123110,58936,8937,0.00952101,0.001,69082144,526727,7255610960,526711032,1100234070,6.48E+13,7782321992,9.52E-06,1.05E-02,10475.33958,80258699775,3.64E+13,69608871,595793176,7256137687,1791677,46916,4032785
75312,58146,4985,0.00082185,0.2,3599013,57973692,4379091552,289857810,375430320,2.18E+13,4668949362,0.000164,2.01E-01,61709.4817,4126383451,2.09E+14,61572705,293456823,4437065244,55944,84223,103372
105027,11447,2018,0.00034241,0.17,411688,3927476,1202244069,23100046,211944486,2.43E+12,1225344115,5.82E-05,1.70E-01,12337.22495,830730.6704,1.62E+12,4339164,23511734,1206171545,4055,10393,8677
65927,37645,6916,0.00370564,0.001,9196806,260375,2481821915,260352820,455951132,1.72E+13,2742174735,3.71E-06,4.71E-03,1689.590753,14629068094,2.39E+12,9457181,269549626,2482082290,107516,3382,341839
51199,99049,3147,2.09E-05,0.17,105889,53004182,5071209751,311707203,161123253,1.60E+13,5382916954,3.55E-06,1.70E-01,571.9230988,16661297.36,5.61E+12,53110071,311813092,5124213933,4432,4967,6971
35211,64940,6480,0.00296184,0.05,6772767,21041204,2286602340,420811200,228167280,1.48E+13,2707413540,0.000148,5.30E-02,33789.74883,21943062.89,1.43E+14,27813971,427583967,2307643544,77867,43000,241327
55933,4529,5986,0.00019487,0.23,49372,6236749,253320557,27110594,334814938,1.52E+12,280431151,4.48E-05,2.30E-01,15006.439,88648907.27,3.08E+11,6286121,27159966,259557306,4371,4415,5909
30037,25188,20938,0.00491597,0.001,3719452,527402,756571956,527386344,628914706,1.58E+13,1283958300,4.92E-06,5.92E-03,3091.725827,77874390.14,1.96E+12,4246854,531105796,757099358,109848,5441,412362
6047,36089,7931,0.00082185,0.05,179359,14312860,218230183,286221859,47958757,1.73E+12,504452042,4.11E-05,5.08E-02,1970.745222,426733345.9,2.57E+12,14492219,286401218,232543043,5706,3764,12046
15007,11129,9845,0.00952101,0.3,1590234,32870932,167012903,109565005,147743915,1.64E+12,276577908,0.00286,3.10E-01,422001.3876,4226808099,5.23E+13,34461166,111155239,199883835,17532,32342,88301
59492,123,22914,0.00296184,0.27,21783,764849,7317516,2818422,1363199688,1.68E+11,10135938,8.00E-04,2.73E-01,1090146.428,84425784.5,16660705767,786632,2840205,8082365,10627,6449,14558
117552,12821,4306,0.00370564,0.17,5584941,9385577,1507134192,55207226,506178912,6.49E+12,1562341418,0.00063,1.74E-01,318871.86,3126313501,5.24E+13,14970518,60792167,1516519769,70970,91377,160002
100469,30325,5322,1.65E-05,0.13,50303,20983818,3046722425,161389650,534696018,1.62E+13,3208112075,2.15E-06,1.30E-01,1147.618063,2677039.829,1.06E+12,21034121,161439953,3067706243,13292,3014,13227
72072,14107,3121,0.00163948,0.2,1666966,8807466,1016719704,44027947,224936712,3.17E+12,1060747651,0.000328,2.02E-01,73755.84812,1040473749,1.47E+13,10474432,45694913,1025527170,11251,31792,30136
94465,51682,6557,0.00041097,0.2,2006454,67785848,4882140130,338878874,619407005,3.20E+13,5221019004,8.22E-05,2.00E-01,50911.53937,657802544.4,1.36E+14,69792302,340885328,4949925978,55385,99362,89409
57825,32483,35735,0.00491597,0.05,9234083,58041326,1878329475,1160780005,2066376375,6.71E+13,3039109480,0.000246,5.49E-02,507912.2134,49495537285,5.36E+14,67275409,1170014088,1936370801,544814,356427,1763218
16166,4386,41963,0.00082185,0.23,58274,42333061,70904076,184049718,678373858,2.98E+12,254953794,0.000189,2.31E-01,128229.9577,317887640.3,2.47E+12,42391335,184107992,113237137,22028,39014,18381
35049,20477,13805,0.00082282,0.13,590559,36751089,717698373,282684985,483851445,9.91E+12,1000383358,0.000107,1.31E-01,51755.94398,1222853613,2.17E+13,37341648,283275544,754449462,29344,54277,50028
116255,20670,1968,0.00019487,0.13,468285,5289072,2402990850,40678560,228789840,4.73E+12,2443669410,2.53E-05,1.30E-01,5795.955896,460778.4937,2.48E+12,5757357,41146845,2408279922,4952,10176,10290
74086,28276,17981,8.43E-05,0.13,176581,66100710,2094855736,508430756,1332140366,3.77E+13,2603286492,1.10E-05,1.30E-01,14597.19449,412750271.4,1.17E+13,66277291,508607337,2160956446,44307,43715,49921
137558,90180,10377,0.00082487,0.07,10232585,65506555,12404980440,935797860,1427439366,1.29E+14,13340778300,5.77E-05,7.08E-02,82421.63369,3185478397,6.70E+14,75739140,946030445,12470486995,393569,269362,777945
15048,68580,26980,8.43E-05,0.03,86991,55509057,1031991840,1850288400,405995040,2.78E+13,2882280240,2.53E-06,3.01E-02,1026.639658,234689825.7,4.83E+12,55596048,1850375391,1087500897,25590,5997,38532
6032,15690,38978,0.00082185,0.1,77788,61159826,94642080,611564820,235115296,3.69E+12,706206900,8.22E-05,1.01E-01,19322.9506,3031770.949,4.76E+12,61237614,611642608,155801906,12546,16661,26045
146487,88588,2892,2.48E-05,0.27,322219,69186592,12976990356,256196496,423640404,3.75E+13,13233186852,6.70E-06,2.70E-01,2840.127632,121141331.4,2.23E+13,69508811,256518715,13046176948,31729,20246,24383
83694,52794,21184,0.00015297,0.005,675918,5592289,4418541036,1118388096,1772973696,9.36E+13,5536929132,7.65E-07,5.15E-03,1356.058931,1861386156,3.78E+12,6268207,1119064014,4424133325,48459,7169,124371
42025,15307,16899,0.00019487,0.05,125362,12934571,643276675,258672993,710180475,1.09E+13,901949668,9.74E-06,5.02E-02,6919.643458,317756947.2,1.62E+12,13059933,258798355,656211246,15227,11060,24290
133519,8673,9563,0.01084252,0.15,12557252,12443547,1158010287,82939899,1276842197,1.11E+13,1240950186,0.00163,1.61E-01,2076628.059,6003531718,1.56E+14,25000799,95497151,1170453834,362816,290673,804630
123647,55346,8574,0.00370564,0.05,25359395,23727921,6843366862,474536604,1060149378,5.87E+13,7317903466,0.000185,5.37E-02,196426.5971,43485705762,6.02E+14,49087316,499895999,6867094783,696075,239132,1470189
95106,50689,2638,0.00296184,0.07,14278750,9363097,4820828034,133717582,250889628,1.27E+13,4954545616,0.000207,7.30E-02,52016.64551,376667392,1.34E+14,23641847,147996332,4830191131,96529,56278,227261
106342,17139,12962,0.02533638,0.03,46179319,6665150,1822595538,222155718,1378405004,2.36E+13,2044751256,0.00076,5.53E-02,1047713.789,1.50E+11,3.08E+14,52844469,268335037,1829260688,1353598,311376,1494199
73670,82188,1058,0.00860544,0.25,52104532,21748006,6054789960,86954904,77942860,6.41E+12,6141744864,0.00215,2.59E-01,167683.1513,9371449130,1.13E+15,73852538,139059436,6076537966,102126,115521,286789
134298,94088,904,0.00031941,0.17,4036033,14472559,12635830224,85055552,121405392,1.14E+13,12720885776,5.43E-05,1.70E-01,6592.276364,1094566056,5.84E+13,18508592,89091585,12650302783,12178,19451,28458
30805,5385,19289,0.00015297,0.25,25380,25972315,165884925,103871265,594197645,3.20E+12,269756190,3.82E-05,2.50E-01,22723.60344,112577276.2,6.59E+11,25997695,103896645,191857240,14688,7874,13396
22322,21477,18773,0.00108175,0.03,518621,12095996,479409594,403187721,419050906,9.00E+12,882597315,3.25E-05,3.11E-02,13599.24953,681499191.5,6.27E+12,12614617,403706342,491505590,22400,21924,61666
132921,67886,6713,1.65E-05,0.07,148978,31902351,9023475006,455718718,892298673,6.06E+13,9479193724,1.16E-06,7.00E-02,1031.229576,130011237.6,4.75E+12,32051329,455867696,9055377357,25308,6081,32341
31016,1008,39121,0.00108175,0.2,33847,7893095,31264128,39433968,1213376936,1.22E+12,70698096,0.000216,2.01E-01,262514.1001,1323071.065,2.67E+11,7926942,39467815,39157223,11842,15887,19679
62793,65791,10397,0.00296184,0.001,12236201,684035,4131214263,684029027,652858821,4.30E+13,4815243290,2.96E-06,3.96E-03,1933.66337,3816529404,8.37E+12,12920236,696265228,4131898298,212432,10720,677189
78790,45178,14903,0.00082282,0.03,2928967,20199601,3559574620,673287734,1174207370,5.30E+13,4232862354,2.47E-05,3.08E-02,28984.83925,5674400626,5.92E+13,23128568,676216701,3579774221,87908,90382,262913
55493,10658,3561,0.01084252,0.27,6413073,10249678,591444394,37953138,197610573,2.11E+12,629397532,0.00293,2.81E-01,578501.0793,2283579446,6.57E+13,16662751,44366211,601694072,36661,57819,119487
106385,16654,14077,0.00860544,0.1,15247223,23445137,1771735790,234438358,1497581645,2.49E+13,2006174148,0.000861,1.09E-01,1288734.899,42925182020,3.57E+14,38692360,249685581,1795180927,559890,349855,1339151
43989,17481,30620,0.00015297,0.03,117634,16058903,768971709,535268220,1346943180,2.35E+13,1304239929,4.59E-06,3.02E-02,6181.256947,828418237.3,1.89E+12,16176537,535385854,785030612,27229,11599,42542
95810,49355,5903,0.00031941,0.05,1510401,14568004,4728702550,291342565,565566430,2.79E+13,5020045115,1.60E-05,5.03E-02,9032.37867,2050648027,2.20E+13,16078405,292852966,4743270554,26734,32406,68784
126312,55099,4379,0.00160539,0.001,11173063,241321,6959664888,241278521,553120248,3.05E+13,7200943409,1.61E-06,2.61E-03,887.9737149,11253086655,2.70E+12,11414384,252451584,6959906209,162057,3093,355418
139304,50972,4072,0.00041097,0.23,2918156,47738514,7100603488,207557984,567245888,2.89E+13,7308161472,9.45E-05,2.30E-01,53617.8398,5941322.891,1.39E+14,50656670,210476140,7148342002,53528,98097,90175
7395,80807,21131,0.02533638,5.00E-04,15141035,853775,597567765,1707532717,156263745,1.26E+13,2305100482,1.27E-05,2.58E-02,1979.578812,31992765009,1.29E+13,15994810,1722673752,598421540,413924,10611,1626313
47692,38354,2982,0.00015297,0.1,279812,11437713,1829178968,114371628,142217544,5.45E+12,1943550596,1.53E-05,1.00E-01,2175.501771,166878389.8,3.20E+12,11717525,114651440,1840616681,3796,5826,7358
123819,75356,2298,0.00015297,0.2,1427312,34645193,9330504564,173168088,284536062,2.14E+13,9503672652,3.06E-05,2.00E-01,8705.096281,163995308.8,4.94E+13,36072505,174595400,9365149757,22044,37730,26903
77783,47070,4676,0.00860544,0.15,31506946,33021258,3661245810,220099320,363713308,1.71E+13,3881345130,0.00129,1.59E-01,469486.9574,73662503.61,1.04E+15,64528204,251606266,3694267068,267065,207643,798468
66665,37273,19049,0.00018467,0.05,458873,35501782,2484804545,710013377,1269901585,4.73E+13,3194817922,9.23E-06,5.02E-02,11725.63629,4370496.413,1.63E+13,35960655,710472250,2520306327,39378,41471,75247
101577,45138,18252,0.00160539,0.001,7360795,823872,4584982626,823858776,1853983404,8.37E+13,5408841402,1.61E-06,2.61E-03,2976.366417,67173613.66,6.06E+12,8184667,831219571,4585806498,340708,10892,868282
16389,24670,7906,0.00082487,0.3,333536,58513961,404316630,195041020,129571434,3.20E+12,599357650,0.000247,3.01E-01,32063.87663,527343891,1.95E+13,58847497,195374556,462830591,5784,17034,17824
15732,36540,35809,0.00296184,0.03,1702720,39255926,574847280,1308460860,563347188,2.06E+13,1883308140,8.89E-05,3.30E-02,50056.32706,7925918827,6.68E+13,40958646,1310163580,614103206,82127,73441,330644
13770,50980,4266,0.00019487,0.27,136805,58732268,701994600,217480680,58742820,2.99E+12,919475280,5.26E-05,2.70E-01,3090.7476,116715787.1,8.03E+12,58869073,217617485,760726868,3952,6730,6305
89064,6126,17092,0.00019487,0.2,106329,20943592,545606064,104705592,1522281888,9.33E+12,650311656,3.90E-05,2.00E-01,59329.4143,90862998,2.23E+12,21049921,104811921,566549656,22059,27098,30808
146449,30920,5753,0.01084252,0.005,49097568,889430,4528203080,177882760,842521097,2.61E+13,4706085840,5.42E-05,1.58E-02,45675.25922,28245580304,4.37E+13,49986998,226980328,4529092510,898534,76104,1965708
81398,6506,7921,0.02533638,0.1,13419131,5154071,529575388,51534026,644753558,4.19E+12,581109414,0.00253,1.25E-01,1633572.115,10628020181,6.92E+13,18573202,64953157,534729459,190122,147033,225858
134993,37101,12912,0.00491597,0.1,24621432,47905577,5008375293,479048112,1743029616,6.47E+13,5487423405,0.000492,1.05E-01,856868.1301,54044129644,1.18E+15,72527009,503669544,5056280870,1065471,519816,2249967
148170,21606,5358,0.00370564,0.17,11863609,19684234,3201361020,115764948,793894860,1.72E+13,3317125968,0.00063,1.74E-01,500121.0533,14619362118,2.34E+14,31547843,127628557,3221045254,238739,198493,464633
120227,92598,6529,0.00056263,0.03,6263654,18139038,11132779746,604572342,784962083,7.27E+13,11737352088,1.69E-05,3.06E-02,13249.2965,10223819646,1.14E+14,24402692,610835996,11150918784,132503,87700,306709
137372,22903,11822,0.00952101,0.25,29956257,67695673,3146230916,270759266,1624011784,3.72E+13,3416990182,0.00238,2.60E-01,3865558.109,1770657547,2.03E+15,97651930,300715523,3213926589,1146508,977195,2477593
107720,1060,19636,0.00491597,0.3,561670,6248150,114183200,20814160,2115189920,2.24E+12,134997360,0.00147,3.05E-01,3119463.057,330663084.1,3.51E+12,6809820,21375830,120431350,34537,160506,81654
107968,70359,9803,0.00163948,0.03,12454506,20692233,7596520512,689729277,1058410304,7.45E+13,8286249789,4.92E-05,3.16E-02,52057.27576,8546295018,2.58E+14,33146739,702183783,7617212745,354322,163224,839725
141883,46948,12975,0.00491597,0.07,32746499,42643572,6661123084,609150300,1840931925,8.64E+13,7270273384,0.000344,7.49E-02,633497.6281,84975561837,1.40E+15,75390071,641896799,6703766656,1493941,525303,3010492
67179,2277,28970,0.00015297,0.2,23399,13193047,152966583,65964690,1946175630,4.43E+12,218931273,3.06E-05,2.00E-01,59541.29722,101681650.3,3.09E+11,13216446,65988089,166159630,17454,12355,24715
23129,9108,39812,0.00370564,0.15,780691,54395155,210658932,362607696,920811748,8.39E+12,573266628,0.000556,1.54E-01,511829.5269,4661743331,4.25E+13,55175846,363388387,265054087,63049,141443,173960
63437,35271,5740,0.00034241,0.15,766163,30370250,2237486427,202455540,364128380,1.28E+13,2439941967,5.14E-05,1.50E-01,18702.17979,4397630.556,2.33E+13,31136413,203221703,2267856677,21651,45291,29145
84245,37856,7169,8.43E-05,0.13,268820,35281946,3189178720,271389664,603952405,2.29E+13,3460568384,1.10E-05,1.30E-01,6617.929268,9635705.015,9.48E+12,35550766,271658484,3224460666,23049,20061,20565
69831,19384,10150,0.00160539,0.1,2173102,19676123,1353604104,196747600,708784650,1.37E+13,1550351704,0.000161,1.02E-01,113787.5789,1543960901,4.28E+13,21849225,198920702,1373280227,44373,93885,126559
54188,4328,39209,0.00082487,0.07,193488,11881056,234525664,169696552,2124657292,9.20E+12,404222216,5.77E-05,7.08E-02,122679.6242,1289468005,2.30E+12,12074544,169890040,246406720,30246,38995,63023
124329,91906,11723,0.00296184,0.03,33844082,32323702,11426581074,1077414038,1457508867,1.34E+14,12503995112,8.89E-05,3.30E-02,129507.2419,1.07E+11,1.09E+15,66167784,1111258120,11458904776,1285788,303899,2734544
25462,9436,11085,0.00047003,0.25,112933,26151826,240259432,104598060,282246270,2.66E+12,344857492,0.000118,2.50E-01,33166.05357,6259097.63,2.95E+12,26264759,104710993,266411258,13796,23053,5778
66264,17670,17100,0.00041097,0.07,481215,21151878,1170884880,302157000,1133114400,2.00E+13,1473041880,2.88E-05,7.04E-02,32597.32175,1892553933,1.02E+13,21633093,302638215,1192036758,28966,51649,64748
107105,64876,1003,0.00491597,0.17,34159216,11062117,6948543980,65070628,107426315,6.97E+12,7013614608,0.000836,1.75E-01,89777.7721,6852262050,3.78E+14,45221333,99229844,6959606097,94435,66102,217967
100971,14039,1714,0.00160539,0.2,2275844,4814322,1417531869,24062846,173064294,2.43E+12,1441594715,0.000321,2.02E-01,55567.13739,117016056.3,1.10E+13,7090166,26338690,1422346191,9887,24653,25513
147609,63448,4266,0.00041097,0.03,3848995,8121471,9365495832,270669168,629699994,4.00E+13,9636165000,1.23E-05,3.04E-02,7763.634196,1149369812,3.13E+13,11970466,274518163,9373617303,59302,38151,134915
103492,17776,13899,0.00056263,0.07,1035096,17296539,1839673792,247068624,1438435308,2.56E+13,2086742416,3.94E-05,7.06E-02,56651.48001,3596559674,1.79E+13,18331635,248103720,1856970331,42503,73515,106295
143207,6910,1201,0.00056263,0.25,556771,2075837,989560370,8298910,171991607,1.19E+12,997859280,0.000141,2.51E-01,24191.90946,113672944.2,1.16E+12,2632608,8855681,991636207,3175,11942,6665
127406,2821,3125,0.00163948,0.15,589407,1322940,359412326,8815625,398143750,1.12E+12,368227951,0.000246,1.52E-01,97912.30729,552421237.7,7.80E+11,1912347,9405032,360735266,6764,19151,15902
18802,64811,1937,0.01084252,0.25,13212859,31395432,1218576422,125538907,36419474,2.36E+12,1344115329,0.00271,2.61E-01,98719.71881,6909973591,4.15E+14,44608291,138751766,1249971854,36287,43451,131096
101069,12016,6015,0.00047003,0.27,570855,19517936,1214445104,72276240,607930035,7.30E+12,1286721344,0.000127,2.70E-01,77151.24567,686703235.6,1.11E+13,20088791,72847095,1233963040,14315,60378,28094
146180,57150,9232,0.00182521,0.03,15248457,15828577,8354187000,527608800,1349533760,7.71E+13,8881795800,5.48E-05,3.18E-02,73895.47542,4223126420,2.41E+14,31077034,542857257,8370015577,531894,185495,1048510
73154,2113,19703,0.01084252,0.23,1676192,9576861,154574402,41632439,1441353262,3.05E+12,196206841,0.00249,2.41E-01,3594417.361,990652680.5,1.61E+13,11253053,43308631,164151263,55145,180291,184641
91506,58049,11070,0.00952101,0.03,50574657,19278625,5311831794,642602430,1012971420,5.88E+13,5954434224,0.000286,3.95E-02,289335.3306,1.29E+11,9.75E+14,69853282,693177087,5331110419,1311152,270245,3272531
97553,23513,8539,0.00082487,0.23,1892121,46183960,2293763689,200777507,833005067,1.96E+13,2494541196,0.00019,2.31E-01,158037.8046,16156273.48,8.74E+13,48076081,202669628,2339947649,50488,133728,108325
56604,49011,30399,0.00160539,0.001,4453788,1489918,2774218644,1489885389,1720704996,8.43E+13,4264104033,1.61E-06,2.61E-03,2762.402594,135388113.5,6.64E+12,5943706,1494339177,2775708562,226382,10627,738165
66919,4791,31653,0.00018467,0.2,59217,30335488,320608929,151649523,2118187107,1.01E+13,472258452,3.69E-05,2.00E-01,78233.12261,562222335.6,1.80E+12,30394705,151708740,350944417,29677,31643,41559
128655,36352,14794,0.00034241,0.03,1601425,16134649,4676866560,537791488,1903322070,6.92E+13,5214658048,1.03E-05,3.03E-02,19551.4953,5448975671,2.58E+13,17736074,539392913,4693001209,68441,59504,187993
67286,12208,6241,0.00015297,0.23,125661,17526850,821427488,76190128,419931926,5.13E+12,897617616,3.52E-05,2.30E-01,14774.50695,156841026.8,2.20E+12,17652511,76315789,838954338,7992,19403,15464
80481,13232,24440,1.65E-05,0.2,17583,64684908,1064924592,323390080,1966955640,2.60E+13,1388314672,3.30E-06,2.00E-01,6494.887523,73049298.95,1.14E+12,64702491,323407663,1129609500,40283,7024,33400
37925,3350,38019,0.00370564,0.17,470887,21656188,127048750,127363650,1441870575,4.83E+12,254412400,0.00063,1.74E-01,908319.0572,894961424,1.02E+13,22127075,127834537,148704938,39633,131788,105688
55894,41068,15943,0.00296184,0.05,6798840,32738058,2295454792,654747124,891118042,3.66E+13,2950201916,0.000148,5.30E-02,131967.4531,7587495108,2.23E+14,39536898,661545964,2328192850,187925,139007,586399
59036,60143,16573,0.00163948,0.07,5821265,69776927,3550602148,996749939,978403628,5.88E+13,4547352087,0.000115,7.16E-02,112285.1226,48236886.63,4.06E+14,75598192,1002571204,3620379075,187679,187445,521015
36797,23575,32438,0.00370564,0.03,3214689,22942906,867489275,764725850,1193621086,2.81E+13,1632215125,0.000111,3.37E-02,132693.9012,7299270350,7.38E+13,26157595,767940539,890432181,159281,130528,557553
62754,64099,3521,0.00082487,0.07,3318102,15799258,4022468646,225692579,220956834,1.42E+13,4248161225,5.77E-05,7.08E-02,12758.24646,3504817884,5.24E+13,19117360,229010681,4038267904,27240,36332,67260
140611,80408,1354,0.00108175,0.3,12230681,32674038,11306249288,108872432,190387294,1.53E+13,11415121720,0.000325,3.01E-01,61785.43659,8280072.308,4.00E+14,44904719,121103113,11338923326,60411,71751,130083
38544,26620,39810,0.02533638,5.00E-04,25997561,529893,1026041280,1059742200,1534436640,4.08E+13,2085783480,1.27E-05,2.58E-02,19438.5349,10349075980,1.38E+13,26527454,1085739761,1026571173,1520503,37807,5251564
45591,2151,16961,0.00952101,0.01,934056,364975,98066241,36483111,773268951,1.66E+12,134549352,9.52E-05,1.95E-02,73623.01415,2058720345,3.41E+11,1299031,37417167,98431216,25376,7920,87862
14903,34439,41728,0.00296184,0.01,1520199,14370961,513244417,1437070592,621872384,2.14E+13,1950315009,2.96E-05,1.30E-02,18418.86502,9514909385,2.18E+13,15891160,1438590791,527615378,94457,42646,345419
55058,27994,5426,0.00047003,0.17,724472,25823404,1541293652,151895444,298744708,8.36E+12,1693189096,7.99E-05,1.70E-01,23871.22577,1965444.394,1.87E+13,26547876,152619916,1567117056,17420,36091,24909
37651,2366,28312,0.01084252,0.13,966100,8710192,89082266,66986192,1065975112,2.52E+12,156068458,0.00141,1.41E-01,1502521.341,4648801030,8.41E+12,9676292,67952292,97792458,41543,112144,148227
132017,37185,10015,8.43E-05,0.17,413796,63311833,4909052145,372407775,1322150255,4.92E+13,5281459920,1.43E-05,1.70E-01,18945.48765,4144046.813,2.62E+13,63725629,372821571,4972363978,42438,62737,67584
125836,98014,1445,8.43E-05,0.1,1039618,14165839,12333689704,141630230,181833020,1.78E+13,12475319934,8.43E-06,1.00E-01,1532.670526,75111584.45,1.47E+13,15205457,142669848,12347855543,4819,14756,14347
69622,86391,15894,0.00018467,0.05,1110742,68658396,6014714202,1373098554,1106572068,9.56E+13,7387812756,9.23E-06,5.02E-02,10217.53319,5296217459,7.63E+13,69769138,1374209296,6083372598,47047,79489,148758
31390,8145,17383,0.00041097,0.3,105086,42480795,255671550,141584535,545652370,4.44E+12,397256085,0.000123,3.00E-01,67274.02635,310503268.6,4.46E+12,42585881,141689621,298152345,21036,38281,15317
142593,33066,4014,0.00034241,0.17,1614478,22566082,4714980138,132726924,572368302,1.89E+13,4847707062,5.82E-05,1.70E-01,33317.38715,64804277.85,3.64E+13,24180560,134341402,4737546220,27153,68621,51690
93460,55911,2297,8.43E-05,0.2,440455,25695367,5225442060,128427567,214677620,1.20E+13,5353869627,1.69E-05,2.00E-01,3619.035318,50585970.92,1.13E+13,26135822,128868022,5251137427,13493,13589,10078
102784,27245,4137,0.00491597,0.05,13766890,5636049,2800350080,112712565,425217408,1.16E+13,2913062645,0.000246,5.49E-02,104517.8011,2847587490,7.76E+13,19402939,126479455,2805986129,152810,73614,351606
38018,17384,43359,0.00015297,0.05,101102,37689123,660904912,753752856,1648422462,2.87E+13,1414657768,7.65E-06,5.02E-02,12607.9592,2191767.627,3.81E+12,37790225,753853958,698594035,41004,16334,51263
15810,58668,32337,0.00370564,0.03,3437345,56916445,927541080,1897147116,511247970,3.00E+13,2824688196,0.000111,3.37E-02,56835.02783,14449055454,1.96E+14,60353790,1900584461,984457525,158163,85489,618119
49561,3870,17020,0.00018467,0.13,35428,8564999,191801070,65867400,843528220,3.26E+12,257668470,2.40E-05,1.30E-01,20250.66633,42199273.15,3.03E+11,8600427,65902828,200366069,9850,7569,13711
61733,91624,10068,0.00182521,0.07,10323876,64579233,5656224392,922470432,621527844,5.69E+13,6578694824,0.000128,7.18E-02,79409.31853,51969995.72,6.67E+14,74903109,932794308,5720803625,201656,145195,556620
31912,92732,16510,0.00952101,5.00E-04,28175994,765514,2959263584,1531005320,526867120,4.89E+13,4490268904,4.76E-06,1.00E-02,2508.153559,2325860958,2.16E+13,28941508,1559181314,2960029098,699037,12098,2385137
102606,22296,17877,0.00031941,0.13,730736,51817920,2287703376,398585592,1834287462,4.09E+13,2686288968,4.15E-05,1.30E-01,76165.66857,3265749512,3.79E+13,52548656,399316328,2339521296,54565,130726,109951
32660,791,4875,0.02533638,0.25,655158,965121,25834060,3856125,159217500,1.26E+11,29690185,0.00633,2.75E-01,1008498.771,223362307.7,6.32E+11,1620279,4511283,26799181,5282,17948,17169
55224,40875,21271,0.00491597,0.07,11097102,60864647,2257281000,869452125,1174669704,4.80E+13,3126733125,0.000344,7.49E-02,404224.8717,59009612972,6.75E+14,71961749,880549227,2318145647,400954,266075,1247153
45617,81712,21115,0.00082185,0.03,3063416,51761189,3727456304,1725348880,963202955,7.87E+13,5452805184,2.47E-05,3.08E-02,23748.25046,4527873096,1.59E+14,54824605,1728412296,3779217493,109461,124622,365326
38715,92601,5737,0.01084252,0.13,38872170,69065258,3585047715,531251937,222107955,2.06E+13,4116299652,0.00141,1.41E-01,313067.2928,223002649,2.68E+15,107937428,570124107,3654112973,339288,207221,1162788
68384,4115,26540,0.00047003,0.15,132272,16382534,281400160,109212100,1814911360,7.47E+12,390612260,7.05E-05,1.50E-01,127959.418,35103533.67,2.17E+12,16514806,109344372,297782694,22793,43641,40043
133679,13487,7659,0.00082487,0.3,1487237,30993608,1802928673,103296933,1023847461,1.38E+13,1906225606,0.000247,3.01E-01,253362.3165,2619774799,4.61E+13,32480845,104784170,1833922281,42304,145519,88080
82573,29733,4200,0.00031941,0.23,784205,28723512,2455143009,124878600,346806600,1.03E+13,2580021609,7.35E-05,2.30E-01,25477.9041,32936283.6,2.25E+13,29507717,125662805,2483866521,18522,43640,24266
109675,47492,3787,0.00013363,0.25,696053,44970395,5208685100,179852204,415339225,1.97E+13,5388537304,3.34E-05,2.50E-01,13875.44516,342665773.6,3.13E+13,45666448,180548257,5253655495,24226,44526,22877
49943,12079,14898,0.00082185,0.13,495814,23396199,603261497,179952942,744050814,8.99E+12,783214439,0.000107,1.31E-01,79494.76099,36931431.46,1.16E+13,23892013,180448756,626657696,23836,62287,47425
123847,68800,5675,0.00041097,0.005,3501757,1952208,8520673600,390440000,702831725,4.84E+13,8911113600,2.05E-06,5.41E-03,1444.21377,596171444.3,6.84E+12,5453965,393941757,8522625808,62630,8917,150304
149264,9700,6006,0.00160539,0.27,2324465,15732577,1447860800,58258200,896479584,8.70E+12,1506119000,0.000433,2.72E-01,388583.827,2373239744,3.66E+13,18057042,60582665,1463593377,43640,129514,107970
128402,19670,8608,0.00296184,0.17,7480805,28785233,2525667340,169319360,1105284416,2.17E+13,2694986700,0.000504,1.73E-01,556524.8511,3219659947,2.15E+14,36266038,176800165,2554452573,218170,231416,449390
69100,65584,13067,0.00160539,0.05,7275473,42851548,4531854400,856986128,902929700,5.92E+13,5388840528,8.03E-05,5.16E-02,72477.71555,950675699.4,3.12E+14,50127021,864261601,4574705948,182231,152259,535835
90585,78621,2855,0.00108175,0.3,7704212,67345454,7121883285,224462955,258620175,2.03E+13,7346346240,0.000325,3.01E-01,83928.71229,1099759882,5.19E+14,75049666,232167167,7189228739,79993,103174,139364
149386,83333,9310,0.00078778,0.05,9806981,38792325,12448783538,775830230,1390783660,1.16E+14,13224613768,3.94E-05,5.08E-02,54781.57758,9130226410,3.80E+14,48599306,785637211,12487575863,362932,211931,725007
20102,62240,2590,0.00160539,0.1,2008661,16121999,1251148480,161201600,52064180,3.24E+12,1412350080,0.000161,1.02E-01,8358.331393,520222545.9,3.24E+13,18130660,163210261,1267270479,7767,8727,29341
22079,2825,44824,0.00082487,0.25,51468,31667588,62373175,126627800,989669096,2.80E+12,189000975,0.000206,2.51E-01,204087.0868,392051293.8,1.63E+12,31719056,126679268,94040763,21282,44452,27092
119817,74992,3931,0.00082282,0.2,7393337,58973675,8985316464,294793552,471000627,3.53E+13,9280110016,0.000165,2.01E-01,77509.74718,3778197124,4.36E+14,66367012,302186889,9044290139,111017,121761,205712
68763,22125,26334,0.00370564,0.05,5638018,29133526,1521381375,582639750,1810804842,4.01E+13,2104021125,0.000185,5.37E-02,335509.5427,7423148633,1.64E+14,34771544,588277768,1550514901,252697,233769,802561
100418,12095,14023,0.00047003,0.05,570886,8480872,1214555710,169608185,1408161614,1.70E+13,1384163895,2.35E-05,5.05E-02,33093.91017,80054168.7,4.84E+12,9051758,170179071,1223036582,27516,32241,65389
119502,42923,12868,0.00160539,0.01,8234812,5523508,5129384346,552333164,1537751736,6.60E+13,5681717510,1.61E-05,1.16E-02,24686.91259,15894545239,4.55E+13,13758320,560567976,5134907854,324399,74533,728253
57689,2332,17784,0.00041097,0.15,55290,6221159,134530748,41472288,1025941176,2.39E+12,176003036,6.16E-05,1.50E-01,63244.65677,245810899.3,3.44E+11,6276449,41527578,140751907,10413,11725,17240
6527,4189,7228,0.02533638,0.17,692855,5147878,27341603,30278092,47177156,1.98E+11,57619695,0.00431,1.95E-01,203200.7198,5007104.795,3.57E+12,5840733,30970947,32489481,5480,7281,25803
69732,17582,11596,0.00860544,0.03,10551147,6117218,1226028024,203880872,808612272,1.42E+13,1429908896,0.000258,3.86E-02,208753.9317,15904683718,6.45E+13,16668365,214432019,1232145242,202003,103477,641712
131178,35577,11636,0.00108175,0.01,5048494,4139823,4666919706,413973972,1526387208,5.43E+13,5080893678,1.08E-05,1.11E-02,16511.69362,15860786148,2.09E+13,9188317,419022466,4671059529,189823,44507,433479
25996,6189,33062,0.00108175,0.27,174070,55256105,160889244,204620718,859479752,5.32E+12,365509962,0.000292,2.71E-01,251030.3999,1150834922,9.62E+12,55430175,204794788,216145349,31681,87979,39665
71807,58557,1556,0.00952101,0.3,40034631,27347839,4204802499,91114692,111731692,6.54E+12,4295917191,0.00286,3.10E-01,319139.5671,12458570419,1.09E+15,67382470,131149323,4232150338,103735,143526,333934
41888,38344,4847,0.00041097,0.2,660094,37174876,1606153472,185853368,203031136,7.79E+12,1792006840,8.22E-05,2.00E-01,16687.94119,3199412.085,2.45E+13,37834970,186513462,1643328348,20591,23879,20337
7729,40698,31259,0.00082185,0.03,258528,38165936,314554842,1272178782,241600811,9.83E+12,1586733624,2.47E-05,3.08E-02,5956.788796,2181864514,9.87E+12,38424464,1272437310,352720778,27250,14739,44733
129672,12231,14785,0.00160539,0.27,2546340,48830564,1586018232,180835335,1917200520,2.34E+13,1766853567,0.000433,2.72E-01,831020.7266,2635166724,1.24E+14,51376904,183381675,1634848796,115658,308184,276422
92007,41389,7514,0.00019487,0.07,742091,21772230,3808077723,310996946,691340598,2.86E+13,4119074669,1.36E-05,7.02E-02,9430.507963,1672796975,1.62E+13,22514321,311739037,3829849953,24142,32473,53312
70138,18473,710,0.00952101,0.3,12336413,3939938,1295659274,13115830,49797980,9.20E+11,1308775104,0.00286,3.10E-01,142238.1197,87585492.82,4.86E+13,16276351,25452243,1299599212,13985,22367,46161
13872,7973,39026,0.00952101,0.01,1053184,3111982,110601456,311154298,541368672,4.32E+12,421755754,9.52E-05,1.95E-02,51543.7654,9452044155,3.28E+12,4165166,312207482,113713438,49412,23330,215000
147631,46041,3948,1.65E-05,0.23,112222,41808683,6797078871,181769868,582847188,2.68E+13,6978848739,3.80E-06,2.30E-01,2213.245627,132913098.1,4.69E+12,41920905,181882090,6838887554,21548,7833,16917
7591,29145,34707,0.00047003,0.03,103997,30347629,221239695,1011535515,263460837,7.68E+12,1232775210,1.41E-05,3.05E-02,3715.034916,469190334.8,3.16E+12,30451626,1011639512,251587324,20341,13794,34984
116673,50113,9555,0.00018467,0.13,1079755,62251618,5846834049,478829715,1114810515,5.59E+13,6325663764,2.40E-05,1.30E-01,26763.36751,1341192636,6.72E+13,63331373,479909470,5909085667,50745,121361,84081
119508,18884,15019,0.00370564,0.13,8363157,36873697,2256789072,283618796,1794890652,3.39E+13,2540407868,0.000482,1.34E-01,864658.4174,125601612,3.08E+14,45236854,291981953,2293662769,385854,343648,839769
71639,69020,22101,0.00163948,0.001,8106629,1525433,4944523780,1525411020,1583293539,1.09E+14,6469934800,1.64E-06,2.64E-03,2595.778091,23290878502,1.24E+13,9632062,1533517649,4946049213,306079,13800,983362
35029,26333,8720,2.09E-05,0.2,19261,45930322,922418657,229623760,305452880,8.04E+12,1152042417,4.18E-06,2.00E-01,1275.571227,25192212.84,8.85E+11,45949583,229643021,968348979,4046,3080,5602
72283,38321,5658,0.00182521,0.25,5055806,54214704,2769956843,216820218,408977214,1.57E+13,2986777061,0.000456,2.52E-01,186617.3252,286054500.7,2.74E+14,59270510,221876024,2824171547,70621,111067,156607
137096,99720,5422,0.00082487,0.01,11277055,5407128,13671213120,540681840,743334512,7.41E+13,14211894960,8.25E-06,1.08E-02,6131.543389,15285937669,6.10E+13,16684183,551958895,13676620248,219482,51203,454491
34428,4050,17710,0.00082282,0.25,114746,17934392,139433400,71725500,609719880,2.47E+12,211158900,0.000206,2.51E-01,125422.4279,467323966.4,2.06E+12,18049138,71840246,157367792,10716,30288,22828
64735,22344,20967,0.00182521,0.005,2640181,2342571,1446438840,468486648,1357298745,3.03E+13,1914925488,9.13E-06,6.83E-03,12386.77621,27677012.77,6.18E+12,4982752,471126829,1448781411,90822,20138,307063
108523,4051,1945,0.00163948,0.23,720856,1813190,439626673,7879195,211077235,8.55E+11,447505868,0.000377,2.32E-01,79593.0882,420562956.9,1.31E+12,2534046,8600051,441439863,4465,17533,11228
72301,12307,7195,2.48E-05,0.3,22095,26568249,889808407,88548865,520205695,6.40E+12,978357272,7.45E-06,3.00E-01,3875.012222,1589659.181,5.87E+11,26590344,88570960,916376656,13375,3705,11299
136198,47574,6718,2.48E-05,0.05,160888,15982381,6479483652,319602132,914978164,4.35E+13,6799085784,1.24E-06,5.00E-02,1135.945391,540414.6601,2.57E+12,16143269,319763020,6495466033,18592,4642,22550
44429,12415,7754,0.02533638,0.2,13975571,19253456,551586035,96265910,344502466,4.28E+12,647851945,0.00507,2.25E-01,1745689.078,5418182476,2.69E+14,33229027,110241481,570839491,170789,156355,548258
43016,84592,2317,0.01084252,0.05,39454542,9803126,3638809472,195999664,99668072,8.43E+12,3834809136,0.000542,6.08E-02,54032.6532,11883898519,3.87E+14,49257668,235454206,3648612598,140246,39482,466389
71577,75204,4993,2.48E-05,0.13,133659,48818347,5382876708,375493572,357383961,2.69E+13,5758370280,3.23E-06,1.30E-01,1153.599688,113449252.7,6.53E+12,48952006,375627231,5431695055,7098,7869,20421
146914,8667,7349,0.00160539,0.23,2044304,14650683,1273303638,63693783,1079670986,9.36E+12,1336997421,0.000369,2.32E-01,398657.391,75112252.34,3.00E+13,16694987,65738087,1287954321,44222,135992,112756
132779,10768,4155,0.00082185,0.15,1175160,6711962,1429764272,44741040,551696745,5.94E+12,1474505312,0.000123,1.51E-01,68011.79548,488234009.2,7.89E+12,7887122,45916200,1436476234,14824,47439,38618
89854,60028,4347,0.00034241,0.1,1846915,26094558,5393755912,260941716,390595338,2.34E+13,5654697628,3.42E-05,1.00E-01,13374.37497,240851094.2,4.82E+13,27941473,262788631,5419850470,27142,49650,55197
33120,44807,5074,0.02533638,0.03,37600311,6821513,1484007840,227350718,168050880,7.53E+12,1711358558,0.00076,5.53E-02,127734.0287,24801307361,2.56E+14,44421824,264951029,1490829353,282646,49575,975244
54851,60457,21502,0.00182521,0.01,6052755,13000006,3316126907,1299946414,1179406202,7.13E+13,4616073321,1.83E-05,1.18E-02,21526.63994,130143607.1,7.87E+13,19052761,1305999169,3329126913,217639,87103,703382
96512,93866,5512,0.00370564,0.001,33570539,517398,9059195392,517389392,531974144,4.99E+13,9576584784,3.71E-06,4.71E-03,1971.304667,12952693871,1.74E+13,34087937,550959931,9059712790,462269,11783,1122381
147263,52223,12008,0.00108175,0.07,8319312,43899341,7690515649,627093784,1768334104,9.23E+13,8317609433,7.57E-05,7.11E-02,133902.6792,16982513352,3.65E+14,52218653,635413096,7734414990,381678,276261,757553
92432,73218,3544,2.09E-05,0.17,141310,44123062,6767686176,259484592,327579008,2.40E+13,7027170768,3.55E-06,1.70E-01,1162.774447,500800.1144,6.24E+12,44264372,259625902,6811809238,21843,16863,8372
31953,5391,40318,0.00041097,0.13,70802,28259451,172258623,217354338,1288281054,6.95E+12,389612961,5.34E-05,1.30E-01,68827.83242,142711863.3,2.00E+12,28330253,217425140,200518074,24943,29286,33899
83333,66403,5566,0.00082282,0.05,4553136,18480406,5533561199,369599098,463831478,3.08E+13,5903160297,4.11E-05,5.08E-02,19082.49084,1267134639,8.41E+13,23033542,374152234,5552041605,60880,63234,160464
14725,37683,36266,0.00056263,0.05,312220,68332098,554882175,1366611678,534016850,2.01E+13,1921493853,2.81E-05,5.06E-02,15022.69502,113220043.3,2.13E+13,68644318,1366923898,623214273,32997,34102,77559
81358,78564,546,0.00370564,0.15,23686039,6442835,6391809912,42895944,44421468,3.49E+12,6434705856,0.000556,1.54E-01,24691.4953,1681214285,1.53E+14,30128874,66581983,6398252747,28816,21510,76617
128902,92142,2142,0.00019487,0.13,2314542,25661548,11877288084,197368164,276108084,2.54E+13,12074656248,2.53E-05,1.30E-01,6994.673703,842811908.7,5.94E+13,27976090,199682706,11902949632,24508,36503,40017
60403,5906,3670,0.00082282,0.17,293582,3685821,356740118,21675020,221679010,1.31E+12,378415138,0.00014,1.71E-01,31008.32691,323179727.2,1.08E+12,3979403,21968602,360425939,4008,11939,8805
41775,5755,21336,0.02533638,0.23,6092211,28245965,240415125,122788680,891311400,5.13E+12,363203805,0.00583,2.55E-01,5193998.996,16895175429,1.72E+14,34338176,128880891,268661090,195728,259115,660285
48470,21504,4598,0.00108175,0.13,1127569,12855528,1042298880,98875392,222865060,4.79E+12,1141174272,0.000141,1.31E-01,31340.95623,1296069082,1.45E+13,13983097,100002961,1055154408,11793,27245,29935
135497,9897,9753,0.00056263,0.25,754532,24132602,1341013809,96525441,1321502241,1.31E+13,1437539250,0.000141,2.51E-01,185879.2015,956616157.6,1.82E+13,24887134,97279973,1365146411,32013,110188,63619
99695,31154,1894,0.00056263,0.15,1747533,8851588,3105898030,59005676,188822330,5.88E+12,3164903706,8.44E-05,1.51E-01,15935.56613,430262410.2,1.55E+13,10599121,60753209,3114749618,9337,22355,23348
131378,88955,2286,8.43E-05,0.2,985079,40682873,11686729990,203351130,300330108,2.67E+13,11890081120,1.69E-05,2.00E-01,5062.964961,157631616.8,4.01E+13,41667952,204336209,11727412863,23386,26372,20694
42366,38497,16891,0.00860544,0.07,14035659,45519601,1630963902,650252827,715604106,2.75E+13,2281216729,0.000602,7.86E-02,431066.1739,23706792136,6.39E+14,59555260,664288486,1676483503,379073,209350,1216516
24395,21128,26253,0.00370564,0.001,1910044,554711,515417560,554673384,640441935,1.35E+13,1070090944,3.71E-06,4.71E-03,2373.247252,25070983.97,1.06E+12,2464755,556583428,515972271,65146,3025,269261
121881,29653,9308,0.00041097,0.17,1485355,46923404,3614137293,276010124,1134468348,3.36E+13,3890147417,6.99E-05,1.70E-01,79259.51769,1797274836,6.97E+13,48408759,277495479,3661060697,51411,144229,105452
113860,27761,14604,0.00108175,0.13,3419386,52708816,3160867460,405421644,1662811440,4.62E+13,3566289104,0.000141,1.31E-01,233837.0158,49934995.35,1.80E+14,56128202,408841030,3213576276,147933,251522,344743
69979,68546,3043,0.00047003,0.1,2254655,20858861,4796780534,208585478,212946097,1.46E+13,5005366012,4.70E-05,1.00E-01,10009.1054,205825241.6,4.70E+13,23113516,210840133,4817639395,12304,36321,41229
19491,81315,1477,0.00163948,0.03,2598486,3604274,1584910665,120102255,28788207,2.34E+12,1705012920,4.92E-05,3.16E-02,1415.930688,268651609.2,9.37E+12,6202760,122700741,1588514939,6003,3635,21594
79507,74334,5432,2.09E-05,0.07,123403,28266480,5910073338,403782288,431882024,3.21E+13,6313855626,1.46E-06,7.00E-02,631.2387663,154173936.6,3.49E+12,28389883,403905691,5938339818,18370,4188,22267
138453,75000,10795,8.43E-05,0.05,875276,40483038,10383975000,809625000,1494600135,1.12E+14,11193600000,4.21E-06,5.01E-02,6298.992269,1228303492,3.54E+13,41358314,810500276,10424458038,48827,47263,102548
32824,52078,1674,0.00182521,0.13,3120041,11334699,1709408272,87178572,54947376,2.86E+12,1796586844,0.000237,1.32E-01,13037.76502,26114643.33,3.54E+13,14454740,90298613,1720742971,7860,9309,28228
18159,83039,7073,0.00056263,0.01,848422,5873684,1507905201,587334847,128438607,1.07E+13,2095240048,5.63E-06,1.06E-02,722.6341346,60006815.9,4.98E+12,6722106,588183269,1513778885,14597,4499,39817
53340,59301,6367,0.00370564,0.005,11721400,1887871,3163115340,377569467,339615780,2.01E+13,3540684807,1.85E-05,8.71E-03,6292.469095,746299419.6,2.21E+13,13609271,389290867,3165003211,123723,23682,397531
15815,85187,24778,0.00952101,0.01,12827697,21108576,1347232405,2110763486,391864070,3.34E+13,3457995891,9.52E-05,1.95E-02,37309.41729,158913866.5,2.71E+14,33936273,2123591183,1368340981,436791,69142,1648487
92822,1831,22544,0.00370564,0.13,630133,5368993,169957082,41278064,2092579168,3.83E+12,211235146,0.000482,1.34E-01,1008064.859,3549551455,3.38E+12,5999126,41908197,175326075,37091,107754,97672
125362,7478,3447,0.02533638,0.25,23753714,6445724,937457036,25776666,432122814,3.23E+12,963233702,0.00633,2.75E-01,2737106.956,22105532679,1.53E+14,30199438,49530380,943902760,195685,218988,205366
56839,2877,33754,0.00296184,0.27,484368,26221732,163525803,97110258,1918543606,5.52E+12,260636061,8.00E-04,2.73E-01,1534253.182,16348320.02,1.27E+13,26706100,97594626,189747535,44390,186764,102636
23901,96813,1845,0.00047003,0.23,1087659,41086441,2313927513,178619985,44097345,4.27E+12,2492547498,0.000108,2.30E-01,4767.227266,461529573.3,4.47E+13,42174100,179707644,2355013954,4628,7263,13051
142530,35326,8124,0.00041097,0.23,2069269,66008367,5035014780,286988424,1157913720,4.09E+13,5322003204,9.45E-05,2.30E-01,109449.5943,840525297.8,1.37E+14,68077636,289057693,5101023147,69588,174590,131278
30329,16642,17736,0.02533638,0.05,12788303,14758482,504735218,295162512,537915144,8.95E+12,799897730,0.00127,7.53E-02,681441.1248,61238933275,1.89E+14,27546785,307950815,519493700,334803,111391,1143968
56141,83029,2382,0.01084252,0.27,50541517,53408952,4661331089,197775078,133727862,1.11E+13,4859106167,0.00293,2.81E-01,391485.6949,36116295295,2.70E+15,103950469,248316595,4714740041,186856,225237,615666
32537,12527,12599,0.00015297,0.3,62353,47354227,407590999,157827673,409933663,5.14E+12,565418672,4.59E-05,3.00E-01,18812.26573,196384377.3,2.95E+12,47416580,157890026,454945226,21785,15075,9062
65055,66065,2145,0.00047003,0.25,2020147,35441589,4297858575,141709425,139542975,9.22E+12,4439568000,0.000118,2.50E-01,16397.34613,216658134.5,7.16E+13,37461736,143729572,4333300164,7723,21796,27301
54522,98968,11916,0.00491597,0.005,26526417,5896957,5395933296,1179302688,649684152,6.43E+13,6575235984,2.46E-05,9.92E-03,15969.139,47413012467,1.56E+14,32423374,1205829105,5401830253,510774,82022,1645339
78453,12406,22122,0.00018467,0.15,179750,41170045,973287918,274445532,1735537266,2.15E+13,1247733450,2.77E-05,1.50E-01,48075.25004,3976143.68,7.40E+12,41349795,274625282,1014457963,28713,53659,55918
41602,70544,21251,0.00082185,0.01,2411978,14991852,2934771488,1499130544,884084102,6.24E+13,4433902032,8.22E-06,1.08E-02,7265.845192,8713550315,3.62E+13,17403830,1501542522,2949763340,89378,40154,290647
58834,6003,14521,0.00860544,0.17,3039440,14819867,353180502,87169563,854328514,5.13E+12,440350065,0.00146,1.79E-01,1249818.37,6619993834,4.50E+13,17859307,90209003,368000369,69717,120379,234240
22533,7498,34757,0.00082487,0.15,139381,39096417,168952434,260607986,783179481,5.87E+12,429560420,0.000124,1.51E-01,96903.18877,1210966849,5.45E+12,39235798,260747367,208048851,26212,56453,41792
38778,98979,839,0.00952101,0.25,36544847,20776027,3838207662,83043381,32534742,3.22E+12,3921251043,0.00238,2.60E-01,77440.90098,3985811928,7.59E+14,57320874,119588228,3858983689,46413,50067,156666
34534,56910,9942,0.00078778,0.1,1548295,56585233,1965329940,565799220,343337028,1.95E+13,2531129160,7.88E-05,1.01E-01,27047.40439,2308901676,8.76E+13,58133528,567347515,2021915173,26283,54581,89472
74175,11408,6014,8.43E-05,0.27,71331,18527566,846188400,68607712,446088450,5.09E+12,914796112,2.28E-05,2.70E-01,10152.21477,214474.9372,1.32E+12,18598897,68679043,864715966,8062,7919,11145
2079,67327,14202,0.00108175,0.07,151437,66936232,139972833,956178054,29525958,1.99E+12,1096150887,7.57E-05,7.11E-02,2235.779355,580609221.2,1.01E+13,67087669,956329491,206909065,15531,5053,24588
46168,2069,26952,0.00108175,0.27,103340,15057930,95521592,55763688,1244319936,2.57E+12,151285280,0.000292,2.71E-01,363431.6345,556992631,1.56E+12,15161270,55867028,110579522,15637,48579,27762
134749,18799,15045,0.00019487,0.17,493651,48085605,2533146451,282830955,2027298705,3.81E+13,2815977406,3.31E-05,1.70E-01,67160.14877,3713363.637,2.37E+13,48579256,283324606,2581232056,38510,110752,79031
51008,40865,26867,0.00034241,0.03,713751,32938618,2084441920,1097919955,1370431936,5.60E+13,3182361875,1.03E-05,3.03E-02,14077.48798,958794243.6,2.35E+13,33652369,1098633706,2117380538,56228,61818,140603
71634,62555,7129,0.00370564,0.05,16605643,22299523,4481064870,445954595,510678786,3.19E+13,4927019465,0.000185,5.37E-02,94619.58683,17756784762,3.70E+14,38905166,462560238,4503364393,209154,113888,628784
54380,14961,17557,0.00296184,0.2,2409844,52539011,813579180,262670277,954749660,1.43E+13,1076249457,0.000592,2.03E-01,565563.1466,8461390236,1.27E+14,54948855,265080121,866118191,83110,169717,228736
54541,85746,2096,0.00163948,0.2,7667454,35961934,4676672586,179723616,114317936,9.80E+12,4856396202,0.000328,2.02E-01,37484.39394,3696257369,2.76E+14,43629388,187391070,4712634520,26428,38811,87795
146360,39852,632,0.00952101,0.07,55534478,1764619,5832738720,25186464,92499520,3.69E+12,5857925184,0.000666,7.95E-02,61648.21984,35097212.25,9.80E+13,57299097,80720942,5834503339,113361,32861,242552
49834,71891,18160,0.00163948,5.00E-04,5873715,652806,3582616094,1305540560,904985440,6.51E+13,4888156654,8.20E-07,2.14E-03,741.8527646,13866459646,3.83E+12,6526521,1311414275,3583268900,177081,3200,580084
51484,5311,9279,0.00160539,0.13,438986,6407246,273431524,49280769,477720036,2.54E+12,322712293,0.000209,1.32E-01,99700.50592,936824299.9,2.81E+12,6846232,49719755,279838770,10428,32368,26567
43652,56343,2689,0.00160539,0.1,3948565,15150888,2459484636,151506327,117380228,6.61E+12,2610990963,0.000161,1.02E-01,18844.10442,10617333.75,5.98E+13,19099453,155454892,2474635524,16630,25058,59011
122822,17565,8972,0.00108175,0.13,2333783,20488267,2157368430,157593180,1101958984,1.94E+13,2314961610,0.000141,1.31E-01,154965.737,10469127.58,4.78E+13,22822050,159926963,2177856697,59896,135236,151498
134287,60579,4184,4.34E-06,0.27,35306,68437961,8134972173,253462536,561856808,3.40E+13,8388434709,1.17E-06,2.70E-01,658.3838076,10340356.62,2.42E+12,68473267,253497842,8203410134,30905,4145,22508
28730,45507,2180,0.00078778,0.15,1029991,14885395,1307416110,99205260,62631400,2.85E+12,1406621370,0.000118,1.51E-01,7400.964644,67359139.61,1.53E+13,15915386,100235251,1322301505,4410,8010,13212
45704,61543,18066,0.00182521,0.03,5134022,33356039,2812761272,1111835838,825688464,5.08E+13,3924597110,5.48E-05,3.18E-02,45211.64524,15767274937,1.71E+14,38490061,1116969860,2846117311,159275,118652,510783
96199,5378,12183,0.00019487,0.27,100820,17691406,517358222,65520174,1171992417,6.30E+12,582878396,5.26E-05,2.70E-01,61664.26382,245652156.2,1.78E+12,17792226,65620994,535049628,14546,25294,25269
8788,25265,12690,0.00296184,0.2,657664,64123914,222028820,320612850,111519720,2.82E+12,542641670,0.000592,2.03E-01,66060.7135,250353589,4.22E+13,64781578,321270514,286152734,12688,21173,71759
106144,74480,14070,2.09E-05,0.03,165070,31439033,7905605120,1047933600,1493446080,1.11E+14,8953538720,6.26E-07,3.00E-02,935.4946245,116126066.1,5.19E+12,31604103,1048098670,7937044153,39126,6409,51685
18680,87174,3927,0.00952101,0.05,15504384,17116948,1628410320,342332298,73356360,6.39E+12,1970742618,0.000476,5.95E-02,34921.33186,4261925057,2.65E+14,32621332,357836682,1645527268,84930,29575,313111
76033,50427,6076,2.48E-05,0.07,95203,21449290,3834116091,306394452,461976508,2.33E+13,4140510543,1.74E-06,7.00E-02,802.9613686,5784418.99,2.04E+12,21544493,306489655,3855565381,16061,3636,18472
41286,39691,34462,0.00952101,0.001,15602380,1367866,1638682626,1367831242,1422798132,5.65E+13,3006513868,9.52E-06,1.05E-02,13546.47524,268836574.4,2.13E+13,16970246,1383433622,1640050492,816803,37171,2768190
39516,61098,35075,0.00182521,5.00E-04,4406785,1071524,2414348568,2143012350,1386023700,8.47E+13,4557360918,9.13E-07,2.33E-03,1264.892159,10819533356,4.72E+12,5478309,2147419135,2415420092,240340,6389,833598
16356,33012,9405,0.00034241,0.07,184887,21734340,539944272,310477860,153828180,5.08E+12,850422132,2.40E-05,7.03E-02,3687.061498,226046366.3,4.02E+12,21919227,310662747,561678612,6737,7905,13892
69755,24013,20871,0.00034241,0.13,573564,65156124,1675026815,501175323,1455856605,3.50E+13,2176202138,4.45E-05,1.30E-01,64804.98182,1556162028,3.74E+13,65729688,501748887,1740182939,54110,122320,105185
84482,53686,3247,0.00082185,0.13,3727535,22667900,4535500652,174318442,274313054,1.47E+13,4709819094,0.000107,1.31E-01,29307.74385,363095892.9,8.45E+13,26395435,178045977,4558168552,35060,48268,75572
7027,41925,49135,0.00056263,0.03,165768,61800676,294606975,2059984875,345271645,1.45E+13,2354591850,1.69E-05,3.06E-02,5827.805569,2198976736,1.02E+13,61966444,2060150643,356407651,40074,16070,63017
93721,84969,13935,0.00370564,0.01,29509586,11841044,7963379649,1184043015,1306002135,1.11E+14,9147422664,3.71E-05,1.37E-02,48395.73752,205606871,3.49E+14,41350630,1213552601,7975220693,995709,173901,2482733
28756,64372,2208,0.00047003,0.23,870090,32691186,1851081232,142133376,63493248,4.09E+12,1993214608,0.000108,2.30E-01,6864.058212,192110067.5,2.84E+13,33561276,143003466,1883772418,4398,8658,12997
83045,33237,6841,8.43E-05,0.07,232663,15917678,2760166665,227374317,568110845,1.89E+13,2987540982,5.90E-06,7.01E-02,3352.024419,795794.54,3.70E+12,16150341,227606980,2776084343,14823,12690,22079
56912,12215,18061,0.00078778,0.17,547674,37505732,695180080,220615115,1027887632,1.26E+13,915795195,0.000134,1.71E-01,137657.3842,4945543.964,2.05E+13,38053406,221162789,732685812,35974,105368,64978
17359,10291,21825,0.00078778,0.25,140741,56153438,178641469,224601075,378860175,3.90E+12,403242544,0.000197,2.51E-01,74614.61717,614287220.2,7.90E+12,56294179,224741816,234794907,18842,44212,21169
99505,79051,581,0.00041097,0.25,3232691,11495960,7865969755,45928631,57812405,4.57E+12,7911898386,0.000103,2.50E-01,5939.791021,1878185.68,3.72E+13,14728651,49161322,7877465715,4893,10940,13844
45640,82059,21251,0.00034241,0.005,1282408,8719610,3745172760,1743835809,969895640,7.96E+13,5489008569,1.71E-06,5.34E-03,1660.50983,1907636866,1.12E+13,10002018,1745118217,3753892370,64687,13476,183623
41666,58649,7960,0.00013363,0.07,326550,32683076,2443669234,466846040,331661360,1.95E+13,2910515274,9.35E-06,7.01E-02,3102.393528,649829564.3,1.07E+13,33009626,467172590,2476352310,23198,13612,30655
73716,7145,28188,1.65E-05,0.3,8696,60430444,526700820,201403260,2077906608,1.48E+13,728104080,4.95E-06,3.00E-01,10291.87143,66181879.23,5.26E+11,60439140,201411956,587131264,36015,5623,32181
110887,16442,13680,0.00047003,0.27,857005,60736995,1823204054,224926560,1516934160,2.49E+13,2048130614,0.000127,2.70E-01,192511.2321,2344644206,5.21E+13,61594000,225783565,1883941049,54230,187144,92654
44348,10834,4056,0.01084252,0.2,5209568,8789129,480466232,43942704,179875488,1.95E+12,524408936,0.00217,2.11E-01,390060.7152,4859805457,4.58E+13,13998697,49152272,489255361,34582,42407,111574
66091,5509,12057,0.00108175,0.23,393919,15280318,364095319,66422013,796859187,4.39E+12,430517332,0.000249,2.31E-01,198260.5579,712315704.3,6.02E+12,15674237,66815932,379375637,15794,61641,35198
4861,8927,17412,0.00491597,0.05,213337,7772530,43394147,155436924,84639732,7.56E+11,198831071,0.000246,5.49E-02,20804.31917,1114320943,1.66E+12,7985867,155650261,51166677,5995,7535,22090
49183,1613,7397,0.00082487,0.3,65447,3580167,79332179,11931361,363806651,5.87E+11,91263540,0.000247,3.01E-01,90027.95766,4840503.19,2.34E+11,3645614,11996808,82912346,4125,9206,6777
36903,66045,14382,0.00082487,0.01,2010477,9498973,2437258635,949859190,530738946,3.51E+13,3387117825,8.25E-06,1.08E-02,4377.906344,2891388245,1.91E+13,11509450,951869667,2446757608,53461,22316,169945
130781,35733,5441,0.00370564,0.1,17317361,19443144,4673197473,194423253,711579421,2.54E+13,4867620726,0.000371,1.04E-01,263685.7166,18844563420,3.37E+14,36760505,211740614,4692640617,326899,186570,659805
144933,68504,10284,0.00082185,0.005,8159860,3522835,9928490232,704495136,1490490972,1.02E+14,10632985368,4.11E-06,5.82E-03,6124.800027,12587199031,2.87E+13,11682695,712654996,9932013067,318293,33481,658566
116663,58064,11449,0.00163948,0.1,11105728,66479354,6773920432,664774736,1335674687,7.76E+13,7438695168,0.000164,1.02E-01,218981.1936,25429848049,7.38E+14,77585082,675880464,6840399786,406905,315838,870537
140117,9051,2663,0.00952101,0.27,12075877,6509660,1268198967,24102813,373131571,3.38E+12,1292301780,0.00257,2.80E-01,959199.1431,8681711444,7.86E+13,18585537,36178690,1274708627,102567,113502,225111
40625,2151,31729,0.00491597,0.27,429697,18432498,87384375,68249079,1288990625,2.77E+12,155633454,0.00133,2.75E-01,1710892.596,6815055.506,7.92E+12,18862195,68678776,105816873,28954,130044,83335
54189,97369,4138,0.01084252,5.00E-04,57209818,201502,5276328741,402912922,224234082,2.18E+13,5679241663,5.42E-06,1.13E-02,1215.631259,54447808044,1.15E+13,57411320,460122740,5276530243,367051,17802,1238983
93824,96479,2950,0.00015297,0.13,1384710,37011967,9052045696,284613050,276780800,2.67E+13,9336658746,1.99E-05,1.30E-01,5504.090667,4084839.719,5.13E+13,38396677,285997760,9089057663,11110,37338,32159
122610,45362,13756,0.00078778,0.001,4381597,624027,5561834820,623999672,1686623160,7.65E+13,6185834492,7.88E-07,1.79E-03,1328.687993,60271944.74,2.73E+12,5005624,628381269,5562458847,183985,3740,446470
102020,19512,3017,0.00491597,0.005,9786286,294417,1990614240,58867704,307794340,6.01E+12,2049481944,2.46E-05,9.92E-03,7565.538708,8857127476,2.88E+12,10080703,68653990,1990908657,76812,11369,189370
104538,13725,9976,0.00041097,0.3,589674,41081323,1434784050,136920600,1042871088,1.43E+13,1571704650,0.000123,3.00E-01,128576.6193,5882380.333,2.42E+13,41670997,137510274,1475865373,31932,107425,48437
85801,54401,12782,0.00082282,0.001,3840724,695376,4667660201,695353582,1096708382,5.97E+13,5363013783,8.23E-07,1.82E-03,902.3935909,12272778434,2.67E+12,4536100,699194306,4668355577,107634,3472,315092
59095,8170,33349,0.00370564,0.25,1789346,68125168,482806150,272461330,1970759155,1.61E+13,755267480,0.000926,2.54E-01,1825730.989,14916222178,1.22E+14,69914514,274250676,550931318,116854,324273,335024
59334,82047,1677,0.00041097,0.25,2000703,34403642,4868176698,137592819,99503118,8.16E+12,5005769517,0.000103,2.50E-01,10223.1991,167756563.3,6.88E+13,36404345,139593522,4902580340,6458,17854,20381
69875,43105,3489,0.00018467,0.3,556230,45123735,3011961875,150393345,243793875,1.05E+13,3162355220,5.54E-05,3.00E-01,13506.42447,252284251.6,2.51E+13,45679965,150949575,3057085610,21887,28433,14403
18793,35076,11349,0.00296184,0.13,1952510,51752957,659183268,398077524,213281757,7.48E+12,1057260792,0.000385,1.33E-01,82121.83709,664732051.8,1.01E+14,53705467,400030034,710936225,29938,36826,121774
73823,35344,10290,0.00163948,0.03,4277782,10911460,2609200112,363689760,759638670,2.68E+13,2972889872,4.92E-05,3.16E-02,37362.3722,44017856.1,4.67E+13,15189242,367967542,2620111572,82225,76391,250988
11152,63633,27722,0.00860544,0.001,6107273,1764112,709635216,1764034026,309155744,1.97E+13,2473669242,8.61E-06,9.61E-03,2660.421206,25393587387,1.08E+13,7871385,1770141299,711399328,237426,12494,904393
66398,8271,22634,0.00491597,0.15,2700016,28083894,549177858,187205814,1502852332,1.24E+13,736383672,0.000737,1.55E-01,1108196.547,10388012790,7.58E+13,30783910,189905830,577261752,108193,222209,340136
34772,46096,6117,0.00160539,0.17,2573235,47941569,1602850112,281969232,212700324,9.80E+12,1884819344,0.000273,1.72E-01,58049.38543,787013079.7,1.23E+14,50514804,284542467,1650791681,41827,35900,87419
82568,693,21690,0.00047003,0.3,26933,4515774,57219624,15031170,1790899920,1.24E+12,72250794,0.000141,3.00E-01,252533.0068,175005373.7,1.22E+11,4542707,15058103,61735398,14213,10975,20068
88021,5833,7747,0.02533638,0.13,13008829,5874794,513426493,45188251,681898687,3.98E+12,558614744,0.00329,1.55E-01,2245989.753,503879162.7,7.64E+13,18883623,58197080,519301287,192252,172695,557272
47934,14916,20271,0.00160539,0.005,1147900,1511975,714983544,302362236,971670114,1.45E+13,1017345780,8.03E-06,6.61E-03,7799.547422,23267609.87,1.74E+12,2659875,303510136,716495519,39600,8514,135931
133138,38851,7940,0.00041097,0.15,2125783,46275834,5172544438,308476940,1057115720,4.11E+13,5481021378,6.16E-05,1.50E-01,65166.42712,4219634767,9.84E+13,48401617,310602723,5218820272,60610,150452,132213
39129,23372,7365,0.00078778,0.23,720459,39595350,914522988,172134780,288185085,6.74E+12,1086657768,0.000181,2.31E-01,52216.08264,2653031.051,2.85E+13,40315809,172855239,954118338,23664,44470,32025
59088,82729,2557,0.00047003,0.15,2297690,31735486,4888291152,211538053,151088016,1.25E+13,5099829205,7.05E-05,1.50E-01,10652.38502,1586270089,7.29E+13,34033176,213835743,4920026638,10728,23852,35492
36515,48044,14458,0.00013363,0.05,234438,34731984,1754326660,694620152,527933870,2.54E+13,2448946812,6.68E-06,5.01E-02,3527.390152,3389398.65,8.14E+12,34966422,694854590,1789058644,17706,12941,41810
50915,8122,21876,0.00860544,0.03,3558968,5330981,413531630,177676872,1113816540,9.05E+12,591208502,0.000258,3.86E-02,287546.4422,13234229152,1.90E+13,8889949,181235840,418862611,119608,99579,418523
58983,15197,10081,0.00082185,0.17,736688,26045650,896364651,153200957,594607623,9.04E+12,1049565608,0.00014,1.71E-01,83075.30674,1856610936,1.92E+13,26782338,153937645,922410301,23981,67632,47097
47557,151,15959,0.00296184,0.25,21290,603052,7181107,2409809,758962163,1.15E+11,9590916,0.00074,2.53E-01,561981.1232,1697182.992,12838977080,624342,2431099,7784159,6323,4093,8831
101001,13359,13713,0.00031941,0.01,430975,1831977,1349272359,183191967,1385026713,1.85E+13,1532464326,3.19E-06,1.03E-02,4423.913824,5909906.477,7.90E+11,2262952,183622942,1351104336,22222,4085,52990
80909,36883,24290,0.00296184,0.001,8838804,895909,2984166647,895888070,1965279610,7.25E+13,3880054717,2.96E-06,3.96E-03,5820.84376,6440705412,7.92E+12,9734713,904726874,2985062556,413670,14817,1229352
37296,37606,28736,0.00019487,0.03,273323,32420518,1402553376,1080646016,1071737856,4.03E+13,2483199392,5.85E-06,3.02E-02,6265.48668,7853996.403,8.86E+12,32693841,1080919339,1434973894,42597,24909,78662
71423,71276,2820,0.00160539,0.25,8172724,50258962,5090745748,200998320,201412860,1.44E+13,5291744068,0.000401,2.52E-01,80836.54783,1152341157,4.11E+14,58431686,209171044,5141004710,63990,72769,138208
41187,7537,39541,0.02533638,0.17,7865362,50665698,310426419,298020517,1628575167,1.23E+13,608446936,0.00431,1.95E-01,7014573.879,40429115486,3.99E+14,58531060,305885879,361092117,474265,483971,1628868
21047,52467,3626,0.00041097,0.25,453836,47563245,1104272949,190245342,76316422,4.00E+12,1294518291,0.000103,2.50E-01,7840.939987,213923111.1,2.16E+13,48017081,190699178,1151836194,4626,10636,12070
5717,29137,19522,0.00182521,0.05,304086,28441366,166576229,568812514,111607274,3.25E+12,735388743,9.13E-05,5.18E-02,10185.33563,5935402.484,8.65E+12,28745452,569116600,195017595,14059,11777,39547
10514,76756,21116,0.00952101,0.001,7684195,1620842,807012584,1620779696,222013624,1.70E+13,2427792280,9.52E-06,1.05E-02,2113.793934,21092027738,1.25E+13,9305037,1628463891,808633426,221169,12113,865168
37532,59453,6002,0.00082185,0.13,1833910,46392598,2231389996,356836906,225267064,1.34E+13,2588226902,0.000107,1.31E-01,24067.64575,5503437.473,8.51E+13,48226508,358670816,2277782594,17791,33265,64141
117874,20280,14705,0.00108175,0.23,2586047,68596439,2390484720,298217400,1733337170,3.52E+13,2688702120,0.000249,2.31E-01,431258.6212,5703864025,1.77E+14,71182486,300803447,2459081159,122423,292864,273457
82372,9634,18351,0.00952101,0.15,7555925,26520487,793571848,176793534,1511608572,1.46E+13,970365382,0.00143,1.60E-01,2158806.05,693264582.7,2.00E+14,34076412,184349459,820092335,275637,323536,784554
97025,60064,18810,0.00296184,5.00E-04,17260949,564928,5827709600,1129803840,1825040250,1.10E+14,6957513440,1.48E-06,3.46E-03,2702.738607,48701187508,9.75E+12,17825877,1147064789,5828274528,774563,9751,1980667
123339,5582,15054,0.00082282,0.15,566496,12605245,688478298,84031428,1856745306,1.04E+13,772509726,0.000123,1.51E-01,229165.0759,4263998.179,7.14E+12,13171741,84597924,701083543,31313,87151,71707
59752,23717,3873,0.00019487,0.25,276166,22970112,1417138184,91855941,231419496,5.49E+12,1508994125,4.87E-05,2.50E-01,11274.1793,320867652.4,6.34E+12,23246278,92132107,1440108296,12451,15684,17069
92485,89971,1540,0.00078778,0.3,6555151,41579185,8320967935,138555340,142426900,1.28E+13,8459523275,0.000236,3.01E-01,33660.31898,1716123117,2.73E+14,48134336,145110491,8362547120,24498,43486,63736
60586,91074,1174,0.00047003,0.17,2593578,18184658,5517809364,106920876,71127964,6.48E+12,5624730240,7.99E-05,1.70E-01,5683.487076,913443356.4,4.72E+13,20778236,109514454,5535994022,5484,12146,17934
38360,1173,39228,0.00952101,0.3,428451,13805663,44996280,46014444,1504786080,1.77E+12,91010724,0.00286,3.10E-01,4298124.995,3865303808,5.92E+12,14234114,46442895,58801943,32491,153915,98610
81220,9793,20130,0.00015297,0.23,121674,45342076,795387460,197133090,1634958600,1.60E+13,992520550,3.52E-05,2.30E-01,57522.91192,563321876.4,5.52E+12,45463750,197254764,840729536,33509,45232,40314
146100,333,5713,0.00163948,0.23,79991,438828,48651300,1902429,834669300,2.78E+11,50553729,0.000377,2.32E-01,314737.4335,2278425.334,35102290548,518819,1982420,49090128,7219,6018,10919
43856,64616,835,0.00082185,0.17,2328998,9176148,2833799296,53954360,36619760,2.37E+12,2887753656,0.00014,1.71E-01,5116.311459,388935977.9,2.14E+13,11505146,56283358,2842975444,3063,6108,11276
13046,64332,3296,0.00108175,0.2,907954,42414790,839275272,212038272,42999616,2.77E+12,1051313544,0.000216,2.01E-01,9302.966922,1496196.17,3.85E+13,43322744,212946226,881690062,5982,7517,18421
143516,82970,14426,0.00163948,5.00E-04,19522372,598479,11907522520,1196925220,2070361816,1.72E+14,13104447740,8.20E-07,2.14E-03,1697.158395,140813232,1.17E+13,20120851,1216447592,11908120999,1019686,8916,2088897
59923,21193,16468,0.00015297,0.2,194272,69804848,1269948139,349006324,986811964,2.09E+13,1618954463,3.06E-05,2.00E-01,30190.52523,319913900.6,1.36E+13,69999120,349200596,1339752987,41501,58674,28158
23423,25991,7506,0.00013363,0.1,81355,19510469,608787193,195088446,175813038,4.57E+12,803875639,1.34E-05,1.00E-01,2349.389627,30531492.9,1.59E+12,19591824,195169801,628297662,4300,4386,7358
137566,53291,1823,0.00082282,0.05,6032133,4858049,7331029706,97149493,250782818,1.34E+13,7428179199,4.11E-05,5.08E-02,10317.45592,1869413647,2.93E+13,10890182,103181626,7335887755,40813,30033,81965
100836,22889,4179,1.65E-05,0.3,38106,28696877,2308035204,95653131,421393644,9.65E+12,2403688335,4.95E-06,3.00E-01,2087.162719,796217.7912,1.09E+12,28734983,95691237,2336732081,13511,3862,10439
71294,12555,10150,0.00015297,0.3,136928,38234288,895096170,127433250,723634100,9.09E+12,1022529420,4.59E-05,3.00E-01,33208.29248,1389767.04,5.24E+12,38371216,127570178,933330458,21481,33930,15272
44253,67431,11192,0.00491597,0.07,14669638,52833012,2984024043,754687752,495279576,3.34E+13,3738711795,0.000344,7.49E-02,170434.5676,41044904744,7.75E+14,67502650,769357390,3036857055,274400,142699,849194
144078,18577,6037,0.00860544,0.25,23033080,28041011,2676537006,112149349,869798886,1.62E+13,2788686355,0.00215,2.59E-01,1871250.531,69524442.24,6.46E+14,51074091,135182429,2704578017,460160,415357,993891
142337,35023,3788,0.00018467,0.27,920621,35824719,4985068751,132667124,539172556,1.89E+13,5117735875,4.99E-05,2.70E-01,26883.6289,523080741.6,3.30E+13,36745340,133587745,5020893470,24467,56140,30830
70144,28104,15281,0.00082282,0.15,1622108,64421830,1971326976,429457224,1071870464,3.01E+13,2400784200,0.000123,1.51E-01,132293.4683,743595126.5,1.04E+14,66043938,431079332,2035748806,68036,160003,146057
80634,20684,7927,0.00182521,0.03,3044292,4919591,1667833656,163962068,639185718,1.32E+13,1831795724,5.48E-05,3.18E-02,34999.44493,241309506.3,1.50E+13,7963883,167006360,1672753247,46083,44351,141227
55349,96715,11719,0.00082185,0.01,4399526,11334909,5353078535,1133403085,648634931,6.27E+13,6486481620,8.22E-06,1.08E-02,5330.80618,1546706759,4.99E+13,15734435,1137802611,5364413444,93976,36564,287769
45026,28960,29123,0.00018467,0.03,240808,25303375,1303952960,843402080,1311292198,3.80E+13,2147355040,5.54E-06,3.02E-02,7264.689906,1893468777,6.09E+12,25544183,843642888,1329256335,38125,16315,70197
108451,35524,7263,4.34E-06,0.27,16720,69667011,3852613324,258010812,787679613,2.80E+13,4110624136,1.17E-06,2.70E-01,923.0029705,32788757.52,1.16E+12,69683731,258027532,3922280335,30319,3380,22259
132457,19331,7923,8.43E-05,0.27,215830,41357178,2560526267,153159513,1049456811,2.03E+13,2713685780,2.28E-05,2.70E-01,23883.85294,222299403.5,8.93E+12,41573008,153375343,2601883445,26538,39246,30108
58118,48222,5507,0.00082282,0.13,2306048,34524565,2802566196,265558554,320055826,1.54E+13,3068124750,0.000107,1.31E-01,34235.28352,1650893842,7.96E+13,36830613,267864602,2837090761,34409,51828,72089
90274,26630,8155,0.00013363,0.13,321249,28234626,2403996620,217167650,736184470,1.96E+13,2621164270,1.74E-05,1.30E-01,12788.92299,445359486.8,9.07E+12,28555875,217488899,2432231246,16874,30343,31963
73131,50502,2161,0.00041097,0.25,1517854,27287646,3693261762,109134822,158036091,7.98E+12,3802396584,0.000103,2.50E-01,16237.02308,229600599.1,4.14E+13,28805500,110652676,3720549408,6231,23583,21207
60994,93086,22530,0.00082185,0.03,4666255,62919878,5677687484,2097227580,1374194820,1.28E+14,7774915064,2.47E-05,3.08E-02,33881.46038,1051296540,2.94E+14,67586133,2101893835,5740607362,203393,188195,609778
121021,67211,6787,0.00108175,0.1,8798971,45618207,8133942431,456161057,821369527,5.52E+13,8590103488,0.000108,1.01E-01,88851.64858,8957712229,4.01E+14,54417178,464960028,8179560638,201818,163787,422713
27893,536,36951,0.00082282,0.15,12319,2975152,14950648,19805736,1030674243,5.52E+11,34756384,0.000123,1.51E-01,127208.9071,77275170.76,36650897488,2987471,19818055,17925800,8533,3773,12347
127634,10546,10568,0.00047003,0.17,632687,18947525,1346028164,111450128,1348836112,1.42E+13,1457478292,7.99E-05,1.70E-01,107778.8844,468026635.6,1.20E+13,19580212,112082815,1364975689,28957,83149,59407
134232,74752,6434,0.00078778,0.07,7904744,33670133,10034110464,480954368,863648688,6.46E+13,10515064832,5.51E-05,7.08E-02,47625.56144,5085865670,2.66E+14,41574877,488859112,10067780597,183919,148019,377280
78174,33465,3187,0.00370564,0.1,9694431,10667164,2616092910,106652955,249140538,8.34E+12,2722745865,0.000371,1.04E-01,92322.51432,7723932355,1.03E+14,20361595,116347386,2626760074,58826,54139,167999
12558,41062,45553,0.00491597,0.005,2535086,9352492,515656596,1870497286,572054574,2.35E+13,2386153882,2.46E-05,9.92E-03,14061.01562,26559177477,2.37E+13,11887578,1873032372,525009088,155031,32585,613558
21956,4311,10563,0.00296184,0.03,280411,1366526,94652316,45537093,231921228,1.00E+12,140189409,8.89E-05,3.30E-02,20607.4071,681095412,3.83E+11,1646937,45817504,96018842,6004,4991,18548
52389,24723,10160,0.00182521,0.23,2364101,57777413,1295213247,251185680,532272240,1.32E+13,1546398927,0.00042,2.32E-01,223446.9815,3602791124,1.37E+14,60141514,253549781,1352990660,59060,99745,131211
101701,41842,2238,0.00108175,0.17,4603367,15923383,4255373242,93642396,227606838,9.52E+12,4349015638,0.000184,1.71E-01,41856.32849,2060414702,7.33E+13,20526750,98245763,4271296625,30243,44069,67647
46008,3427,38603,0.00034241,0.2,54002,26465219,157669416,132292481,1776046824,6.09E+12,289961897,6.85E-05,2.00E-01,121627.2386,2084082.733,1.43E+12,26519221,132346483,184134635,25034,31886,28221
50137,89508,13906,0.00034241,0.005,1536657,6223575,4487662596,1244698248,697205122,6.24E+13,5732360844,1.71E-06,5.34E-03,1193.650029,5342061340,9.56E+12,7760232,1246234905,4493886171,48584,10321,138952
127754,1809,15514,0.00296184,0.25,684605,7017302,231106986,28064826,1981975556,3.59E+12,259171812,0.00074,2.53E-01,1467573.62,530968135.8,4.80E+12,7701907,28749431,238124288,34307,137498,81711
124292,56694,11740,0.00015297,0.05,1077941,33281028,7046610648,665587560,1459188080,8.27E+13,7712198208,7.65E-06,5.02E-02,11160.60003,12654781.16,3.59E+13,34358969,666665501,7079891676,50146,69041,120060
94593,22938,12868,0.00182521,0.001,3960394,295194,2169774234,295166184,1217222724,2.79E+13,2464940418,1.83E-06,2.83E-03,2221.687088,12740264607,1.17E+12,4255588,299126578,2170069428,114246,3114,320499
60675,59591,1302,0.00082487,0.25,2982556,19411207,3615683925,77587482,78998850,4.71E+12,3693271407,0.000206,2.51E-01,16290.94535,504812736.7,5.79E+13,22393763,80570038,3635095132,6961,16268,21997
97667,31659,7394,0.00056263,0.005,1739716,1170489,3092039553,234086646,722149798,2.29E+13,3326126199,2.81E-06,5.56E-03,2031.515704,6431575.568,2.04E+12,2910205,235826362,3093210042,29201,4427,88624
120291,50363,15685,0.00163948,5.00E-04,9932416,394993,6058215633,789943655,1886764335,9.50E+13,6848159288,8.20E-07,2.14E-03,1546.656196,7789424600,3.92E+12,10327409,799876071,6058610626,470700,4865,1077981
94965,93874,4337,2.48E-05,0.05,221355,20359814,8914744410,407131538,411863205,3.87E+13,9321875948,1.24E-06,5.00E-02,511.328169,480004.2054,4.51E+12,20581169,407352893,8935104224,16712,4762,19520
127070,80791,2313,0.00370564,0.23,38042853,42986187,10266112370,186869583,293912910,2.37E+13,10452981953,0.000852,2.34E-01,250501.1502,11439004329,1.64E+15,81029040,224912436,10309098557,308722,226274,609887
68339,67878,14588,0.00019487,0.05,903958,49513154,4638714642,990204264,996929332,6.77E+13,5628918906,9.74E-06,5.02E-02,9713.580946,65933844.75,4.48E+13,50417112,991108222,4688227796,51824,58169,109750
7251,98941,7170,0.00370564,0.005,2658706,3547553,717421191,709406970,51989670,5.14E+12,1426828161,1.85E-05,8.71E-03,963.2750037,571844352.8,9.43E+12,6206259,712065676,720968744,29751,4443,106898
116803,30951,4512,0.00082487,0.01,2982135,1396772,3615169653,139650912,527015136,1.63E+13,3754820565,8.25E-06,1.08E-02,4347.189752,2018248050,4.17E+12,4378907,142633047,3616566425,37113,10879,94128
23678,59269,4095,0.00491597,0.07,6899020,16990523,1403371382,242706555,96961410,5.75E+12,1646077937,0.000344,7.49E-02,33366.15679,7062781239,1.17E+14,23889543,249605575,1420361905,40000,24270,147070
121705,25329,567,0.00952101,0.25,29350302,3596208,3082665945,14361543,69006735,1.75E+12,3097027488,0.00238,2.60E-01,164253.4535,8320751.447,1.06E+14,32946510,43711845,3086262153,47095,42993,108227
23662,99439,17080,0.01084252,0.01,25512474,16984737,2352925618,1698418120,404146960,4.02E+13,4051343738,0.000108,2.08E-02,43819.71497,56646052276,4.33E+14,42497211,1723930594,2369910355,621417,75460,2234546
25482,4615,13555,0.00082185,0.13,96660,8133661,117599430,62556325,345408510,1.59E+12,180155755,0.000107,1.31E-01,36903.61791,1310078.436,7.86E+11,8230321,62652985,125733091,6325,12936,13652
33905,46644,33525,0.00182521,0.001,2886570,1563810,1581464820,1563740100,1136665125,5.30E+13,3145204920,1.83E-06,2.83E-03,2074.652553,16450915924,4.51E+12,4450380,1566626670,1583028630,140949,6628,526615
127133,59982,550,0.00041097,0.17,3133984,5617068,7625691606,32990100,69923150,4.19E+12,7658681706,6.99E-05,1.70E-01,4885.173882,86183088.18,1.76E+13,8751052,36124084,7631308674,4663,10552,13053
103514,73372,10602,0.00860544,0.05,65358925,38895977,7595029208,777889944,1097455428,8.05E+13,8372919152,0.00043,5.86E-02,472204.3419,6929315395,2.54E+15,104254902,843248869,7633925185,1807297,374155,4290100
24568,54188,21455,0.00031941,0.01,425242,11626437,1331290784,1162603540,527106440,2.86E+13,2493894324,3.19E-06,1.03E-02,1683.63068,273697737.9,4.94E+12,12051679,1163028782,1342917221,33330,6663,73243
80346,90436,10559,0.00163948,0.03,11912855,28648123,7266170856,954913724,848373414,7.67E+13,8221084580,4.92E-05,3.16E-02,41726.73734,6289332031,3.41E+14,40560978,966826579,7294818979,247621,141177,727739
10921,22808,39963,0.00056263,0.05,140150,45575335,249086168,911476104,436435923,9.95E+12,1160562272,2.81E-05,5.06E-02,12277.59717,5600548.724,6.39E+12,45715485,911616254,294661503,20995,18308,60762
60889,68114,11435,0.00952101,0.001,39488045,778951,4147393346,778883590,696265715,4.74E+13,4926276936,9.52E-06,1.05E-02,6629.152835,58699955108,3.08E+13,40266996,818371635,4148172297,705052,32151,2341697
11494,2853,46605,0.00018467,0.25,6057,33247564,32792382,132964065,535677870,1.53E+12,165756447,4.62E-05,2.50E-01,24730.90806,141114.5614,2.01E+11,33253621,132970122,66039946,15827,4269,13958
21803,67152,31830,0.00047003,0.03,688197,64124366,1464115056,2137448160,693989490,4.66E+13,3601563216,1.41E-05,3.05E-02,9785.8764,3723799975,4.41E+13,64812563,2138136357,1528239422,55034,55072,147975
7679,9353,28917,0.00056263,0.17,40411,45981891,71821687,270460701,222053643,2.08E+12,342282388,9.56E-05,1.71E-01,21238.787,5842540.435,1.86E+12,46022302,270501112,117803578,5137,11470,10892
111752,42317,13834,0.00491597,0.03,23248105,17563280,4729009384,585413378,1545977168,6.54E+13,5314422762,0.000147,3.49E-02,227999.3214,86834225537,4.08E+14,40811385,608661483,4746572664,914806,264869,2100967
91801,19580,4914,0.00160539,0.27,2885764,25980344,1797463580,96216120,451110114,8.83E+12,1893679700,0.000433,2.72E-01,195536.0698,1417998610,7.50E+13,28866108,99101884,1823443924,38574,83370,88845
78963,53969,12054,0.00108175,0.1,4610005,65057139,4261554147,650542326,951820002,5.14E+13,4912096473,0.000108,1.01E-01,102963.1287,2778408547,3.00E+14,69667144,655152331,4326611286,126125,157924,320767
112323,26954,9080,0.00018467,0.05,559117,12238250,3027554142,244742320,1019892840,2.75E+13,3272296462,9.23E-06,5.02E-02,9417.180538,1269153421,6.84E+12,12797367,245301437,3039792392,22488,21754,48976
55440,5141,29001,0.00082487,0.25,235138,37279543,285017040,149094141,1607815440,8.27E+12,434111181,0.000206,2.51E-01,331559.6805,68181932.7,8.77E+12,37514681,149329279,322296583,33360,109793,56300
56482,79101,21142,0.00034241,0.01,1529820,16724004,4467782682,1672353342,1194142444,9.45E+13,6140136024,3.42E-06,1.03E-02,4088.863143,323433163.4,2.56E+13,18253824,1673883162,4484506686,73080,29631,113337
49013,44515,34930,0.00860544,5.00E-04,18776100,777492,2181813695,1554908950,1712024090,7.62E+13,3736722645,4.30E-06,9.11E-03,7366.360293,1.51E+11,1.46E+13,19553592,1573685050,2182591187,1014919,19841,3386062
39592,40361,33091,0.00056263,0.03,899092,40067827,1597972712,1335585851,1310138872,5.29E+13,2933558563,1.69E-05,3.06E-02,22113.70301,892531167,3.60E+13,40966919,1336484943,1638040539,71637,77400,197556
103676,94652,11685,0.00370564,5.00E-04,36364213,553028,9813140752,1106008620,1211454060,1.15E+14,10919149372,1.85E-06,4.21E-03,2244.606311,84982590637,2.01E+13,36917241,1142372833,9813693780,1122964,12722,2628684
138669,40962,583,0.00860544,0.2,48881411,4783233,5680159578,23880846,80844027,3.31E+12,5704040424,0.00172,2.09E-01,139139.6847,5699439766,2.34E+14,53664644,72762257,5684942811,89464,59500,194821
127790,65053,4354,0.00182521,0.2,15173455,56655624,8313122870,283240762,556397660,3.62E+13,8596363632,0.000365,2.02E-01,203108.5146,8588331830,8.60E+14,71829079,298414217,8369778494,242565,204363,465290
29310,73769,6676,0.00952101,0.13,20586991,64024580,2162169390,492481844,195673560,1.44E+13,2654651234,0.00124,1.40E-01,242191.2898,17866209257,1.32E+15,84611571,513068835,2226193970,199260,136014,720505
108456,33020,1243,0.00082185,0.15,2943260,6159361,3581217120,41043860,134810808,4.45E+12,3622260980,0.000123,1.51E-01,16619.13938,731685309.9,1.81E+13,9102621,43987120,3587376481,9038,21459,25328
137041,80164,8930,0.00108175,0.07,11883908,50111781,10985754724,715864520,1223776130,9.81E+13,11701619244,7.57E-05,7.11E-02,92667.388,3183680782,5.96E+14,61995689,727748428,11035866505,394799,239454,781834
133880,74316,2981,0.00031941,0.25,3177986,55402724,9949426080,221535996,399096280,2.97E+13,10170962076,7.99E-05,2.50E-01,31868.8357,2368364394,1.76E+14,58580710,224713982,10004828804,51755,77887,73438
25857,94297,777,0.00296184,0.25,7221975,18320779,2438237529,73268769,20090889,1.89E+12,2511506298,0.00074,2.53E-01,14876.49967,1402809289,1.32E+14,25542754,80490744,2456558308,8435,12021,29694
27573,5255,16079,0.00370564,0.25,536963,21125291,144896115,84495145,443346267,2.33E+12,229391260,0.000926,2.54E-01,410720.4152,1467668332,1.13E+13,21662254,85032108,166021406,20356,60522,48708
135277,27145,1631,0.00952101,0.17,34962318,7527896,3672094165,44273495,220636787,5.99E+12,3716367660,0.00162,1.80E-01,357116.4594,570230958.3,2.63E+14,42490214,79235813,3679622061,173908,112356,396851
42869,42699,28890,0.00491597,0.01,8998720,12335951,1830463431,1233574110,1238485410,5.29E+13,3064037541,4.92E-05,1.49E-02,60883.57121,44194349321,1.11E+14,21334671,1242572830,1842799382,408871,122593,1357296
90509,15800,2512,0.00018467,0.17,264087,6749641,1430042200,39689600,227358608,3.59E+12,1469731800,3.14E-05,1.70E-01,7137.673404,86239889.24,1.78E+12,7013728,39953687,1436791841,4219,9559,8098
41476,10376,16720,0.00047003,0.25,202287,43373367,430354976,173486720,693478720,7.20E+12,603841696,0.000118,2.50E-01,81488.95069,913171700.6,8.77E+12,43575654,173689007,473728343,24991,60544,25974
90468,62223,2145,0.00082487,0.05,4643385,6674162,5629190364,133468335,194053860,1.21E+13,5762658699,4.12E-05,5.08E-02,8003.460375,298799588.9,3.10E+13,11317547,138111720,5635864526,27311,24789,64282
106489,32431,11851,0.00491597,0.03,16977889,11530770,3453544759,384339781,1262001139,4.09E+13,3837884540,0.000147,3.49E-02,186118.7922,60360185491,1.96E+14,28508659,401317670,3465075529,537290,192479,1280499
98076,86545,2496,0.00078778,0.23,6686732,49686218,8487987420,216016320,244797696,2.12E+13,8704003740,0.000181,2.31E-01,44354.74766,1668992016,3.32E+14,56372950,222703052,8537673638,53517,54401,109676
15965,9188,7794,0.00860544,0.1,1262347,7162015,146686420,71611272,124431210,1.14E+12,218297692,0.000861,1.09E-01,107078.5312,49191877.22,9.04E+12,8424362,72873619,153848435,11460,19247,51730
76892,88312,5917,0.00952101,0.13,64652937,67936839,6790486304,522542104,454969964,4.02E+13,7313028408,0.00124,1.40E-01,563130.565,57382138219,4.39E+15,132589776,587195041,6858423143,680303,452367,2082710
111370,21696,11326,0.00491597,0.2,11878570,49149034,2416283520,245728896,1261376620,2.74E+13,2662012416,0.000983,2.05E-01,1240177.925,40360350376,5.84E+14,61027604,257607466,2465432554,388631,329877,868480
68800,52972,4036,0.00078778,0.3,2871105,64153429,3644473600,213794992,277676800,1.47E+13,3858268592,0.000236,3.01E-01,65624.46885,347625936.4,1.84E+14,67024534,216666097,3708627029,44336,58599,80231
141740,56366,3585,8.43E-05,0.03,673423,6062385,7989316840,202072110,508137900,2.86E+13,8191388950,2.53E-06,3.01E-02,1284.928308,313847165.6,4.08E+12,6735808,202745533,7995379225,12864,6121,26493
94057,77360,1228,0.00034241,0.13,2491480,12353946,7276249520,94998080,115501996,8.94E+12,7371247600,4.45E-05,1.30E-01,5141.374999,91785408.44,3.08E+13,14845426,97489560,7288603466,7097,15713,21946
60210,38677,34680,2.48E-05,0.03,57823,40240996,2328742170,1341318360,2088082800,8.08E+13,3670060530,7.45E-07,3.00E-02,1555.412878,2005290.129,2.33E+12,40298819,1341376183,2368983166,46885,4994,62735
85546,40722,8269,0.00018467,0.2,643324,67353672,3483604212,336730218,707379874,2.88E+13,3820334430,3.69E-05,2.00E-01,26126.36827,5319589.843,4.33E+13,67996996,337373542,3550957884,40270,75459,43857
146206,25865,11554,0.00163948,0.005,6200165,1494290,3781618190,298844210,1689264124,4.37E+13,4080462400,8.20E-06,6.64E-03,13847.57373,3581674945,9.26E+12,7694455,305044375,3783112480,252189,29531,538310
29977,79032,7246,0.00047003,0.05,1113576,28636422,2369142264,572665872,217213342,1.72E+13,2941808136,2.35E-05,5.05E-02,5104.839357,1613782656,3.19E+13,29749998,573779448,2397778686,27940,21145,51167
79522,53053,3289,8.43E-05,0.2,355615,34904243,4218880666,174491317,261547858,1.39E+13,4393371983,1.69E-05,2.00E-01,4409.17379,5847997.427,1.24E+13,35259858,174846932,4253784909,18005,15715,11777
129163,45983,16479,0.00163948,0.005,9737416,3788779,5939302229,757753857,2128477077,9.79E+13,6697056086,8.20E-06,6.64E-03,17447.97799,43324760086,3.69E+13,13526195,767491273,5943091008,525374,60543,1156587
95907,15883,7149,0.00082185,0.27,1251975,30660419,1523290881,113547567,685639143,1.09E+13,1636838448,0.000222,2.71E-01,152142.983,2416486999,3.84E+13,31912394,114799542,1553951300,30894,95088,60286
40692,57996,2757,0.00034241,0.27,808092,43173412,2359973232,159894972,112187844,6.51E+12,2519868204,9.25E-05,2.70E-01,10371.84471,22278722.44,3.49E+13,43981504,160703064,2403146644,4947,15804,15659
43227,20865,37623,0.00018467,0.01,166568,7850458,901931355,785003895,1626329421,3.39E+13,1686935250,1.85E-06,1.02E-02,3003.342542,1566618553,1.31E+12,8017026,785170463,909781813,32313,4286,62111
83552,12121,16359,0.00952101,0.25,9642361,49572309,1012733792,198287439,1366827168,1.66E+13,1211021231,0.00238,2.60E-01,3253393.784,47321263263,4.78E+14,59214670,207929800,1062306101,324400,445472,868415
32532,15113,4393,0.00082487,0.3,405577,19921640,491656116,66391409,142913076,2.16E+12,558047525,0.000247,3.01E-01,35365.4127,17815916.07,8.08E+12,20327217,66796986,511577756,3638,20149,11049
121001,40543,12832,0.00952101,0.01,46708023,5202562,4905743543,520247776,1552684832,6.30E+13,5425991319,9.52E-05,1.95E-02,147831.2781,77915805616,2.43E+14,51910585,566955799,4910946105,1744569,210259,3925819
82445,95465,1114,0.00163948,0.13,12903802,13830231,7870611925,106348010,91843730,8.77E+12,7976959935,0.000213,1.32E-01,19574.8746,143747338.7,1.78E+14,26734033,119251812,7884442156,30481,27596,88976
107212,58453,2093,0.00041097,0.01,2575540,1223525,6266863036,122342129,224394716,1.31E+13,6389205165,4.11E-06,1.04E-02,922.1949643,1347626556,3.15E+12,3799065,124917669,6268086561,15113,3935,39706
40162,32647,25079,0.00034241,0.01,448964,8187630,1311168814,818754113,1007222798,3.29E+13,2129922927,3.42E-06,1.03E-02,3448.831583,2589662108,3.68E+12,8636594,819203077,1319356444,33274,9974,82726
121373,91514,1616,0.00031941,0.23,3547842,34015147,11107328722,147886624,196138768,1.79E+13,11255215346,7.35E-05,2.30E-01,14409.19729,286661582.9,1.21E+14,37562989,151434466,11141343869,17752,36086,43757
106466,78001,7390,1.65E-05,0.05,137108,28822454,8304454466,576427390,786783740,6.14E+13,8880881856,8.26E-07,5.00E-02,649.4899774,172246950.3,3.95E+12,28959562,576564498,8333276920,24005,4571,30230
102078,62059,1237,0.00019487,0.17,1234474,13057148,6334858602,76766983,126270486,7.84E+12,6411625585,3.31E-05,1.70E-01,4183.076033,458113262.7,1.61E+13,14291622,78001457,6347915750,4178,17232,12404
82902,33551,3765,0.00491597,0.3,13673804,37898695,2781445002,126319515,312126030,1.05E+13,2907764517,0.00147,3.05E-01,460320.6599,15444218461,5.18E+14,51572499,139993319,2819343697,122765,154569,290625
119671,24774,2084,0.00019487,0.3,577763,15496608,2964729354,51629016,249394364,6.18E+12,3016358370,5.85E-05,3.00E-01,14579.84391,84280245.73,8.95E+12,16074371,52206779,2980225962,7335,23225,16665
22011,14967,18592,0.00056263,0.07,185361,19480422,329438637,278266464,409228512,6.12E+12,607705101,3.94E-05,7.06E-02,16117.09664,34460655.06,3.61E+12,19665783,278451825,348919059,17103,19817,30234
22259,51656,35988,0.00160539,0.01,1845997,18590789,1149810904,1858996128,801056892,4.14E+13,3008807032,1.61E-05,1.16E-02,12860.08724,4650104665,3.43E+13,20436786,1860842125,1168401693,107572,51245,372518
86323,14752,4849,0.00013363,0.07,170173,5007937,1273436896,71532448,418580227,6.17E+12,1344969344,9.35E-06,7.01E-02,3915.441301,206287821.7,8.52E+11,5178110,71702621,1278444833,6448,4449,11424
59141,47498,2967,0.00015297,0.25,429709,35235565,2809079218,140926566,175471347,8.33E+12,2950005784,3.82E-05,2.50E-01,6710.462988,637467.142,1.51E+13,35665274,141356275,2844314783,4113,17267,10268
54693,74509,17829,0.00370564,5.00E-04,15101032,664216,4075120737,1328420961,975121497,7.27E+13,5403541698,1.85E-06,4.21E-03,1806.724612,53846897648,1.00E+13,15765248,1343521993,4075784953,435869,11183,1421099
41378,75733,860,0.00952101,0.2,29836254,13030594,3133680074,65130380,35585080,2.69E+12,3198810454,0.0019,2.10E-01,67761.18051,769763622.5,3.89E+14,42866848,94966634,3146710668,38519,35595,131590
119750,92934,17769,0.00047003,0.03,5230973,49543162,11128846500,1651344246,2127837750,1.98E+14,12780190746,1.41E-05,3.05E-02,30004.42733,929477149.8,2.59E+14,54774135,1656575219,11178389662,299467,208217,700482
41805,17849,31623,0.00018467,0.05,137806,28223487,746177445,564438927,1321999515,2.36E+13,1310616372,9.23E-06,5.02E-02,12206.68252,740782059.5,3.89E+12,28361293,564576733,774400932,32166,21269,49874
111548,15775,5044,0.00041097,0.17,723216,13529971,1759669700,79569100,562648112,8.88E+12,1839238800,6.99E-05,1.70E-01,39309.35408,18238384.14,9.79E+12,14253187,80292316,1773199671,13709,45224,31501
53139,69432,7179,0.00082487,0.13,3043446,64807605,3689547048,498452328,381484881,2.65E+13,4187999376,0.000107,1.31E-01,40907.80639,109242723.6,1.97E+14,67851051,501495774,3754354653,34810,77596,125870
87668,65834,24356,0.00013363,0.005,771258,8017660,5771535112,1603452904,2135241808,1.41E+14,7374988016,6.68E-07,5.13E-03,1426.661814,187845707.7,6.18E+12,8788918,1604224162,5779552772,65131,9618,167450
45456,63573,981,0.00082487,0.3,2383756,18727218,2889774288,62365113,44592336,2.83E+12,2952139401,0.000247,3.01E-01,11034.86406,303991745.6,4.46E+13,21110974,64748869,2908501506,4099,9322,13622
103366,89110,3973,0.00041097,0.13,3785456,46024857,9210944260,354034030,410673118,3.66E+13,9564978290,5.34E-05,1.30E-01,21940.66307,1052763646,1.74E+14,49810313,357819486,9256969117,37610,74471,106525
20763,47182,13688,0.00108175,0.07,1059744,45208428,979639866,645827216,284203944,1.34E+13,1625467082,7.57E-05,7.11E-02,21520.63315,3626380405,4.79E+13,46268172,646886960,1024848294,42623,42627,102121
109280,45255,2466,8.43E-05,0.25,416862,27909834,4945466400,111598830,269484480,1.22E+13,5057065230,2.11E-05,2.50E-01,5678.711705,51398019.64,1.16E+13,28326696,112015692,4973376234,15128,17427,16263
71236,66442,8516,0.00019487,0.05,922348,28294144,4733062312,565820072,606645776,4.03E+13,5298882384,9.74E-06,5.02E-02,5910.853118,1178186709,2.61E+13,29216492,566742420,4761356456,31686,33339,66917
85968,94836,4508,0.00047003,0.15,3832138,64138630,8152861248,427520688,387543744,3.68E+13,8580381936,7.05E-05,1.50E-01,27323.5779,17275058.89,2.46E+14,67970768,431352826,8216999878,37487,81538,112597
31097,21225,49664,0.00860544,0.001,5679995,1054136,660033825,1054118400,1544401408,3.28E+13,1714152225,8.61E-06,9.61E-03,13290.25365,14104281689,5.99E+12,6734131,1059798395,661087961,402009,16784,1457801
51916,27949,36880,0.01084252,0.05,15732951,51540348,1451000284,1030759120,1914662080,5.35E+13,2481759404,0.000542,6.08E-02,1037988.095,98636479488,8.11E+14,67273299,1046492071,1502540632,914490,384381,3028297
110562,10163,10943,0.00182521,0.23,2050936,25580437,1123641606,111213709,1209879966,1.23E+13,1234855315,0.00042,2.32E-01,507905.5529,11221400.29,5.25E+13,27631373,113264645,1149222043,58619,176495,151283
15574,1511,24230,0.02533638,0.3,596310,10984749,23532314,36611530,377358020,5.70E+11,60143844,0.0076,3.25E-01,2868265.857,1444649903,6.55E+12,11581059,37207840,34517063,19129,56431,74926
105649,11312,19683,0.01084252,0.1,12958078,22265552,1195101488,222654096,2079489267,2.35E+13,1417755584,0.00108,1.11E-01,2254690.397,38257586652,2.89E+14,35223630,235612174,1217367040,640063,428483,1590218
15741,78006,23585,0.00078778,0.005,967347,9199192,1227892446,1839771510,371251485,2.90E+13,3067663956,3.94E-06,5.79E-03,1462.322474,684419561.6,8.90E+12,10166539,1840738857,1237091638,49101,8097,150104
108501,93545,10448,0.00013363,0.07,1356329,68421985,10149726045,977358160,1133618448,1.06E+14,11127084205,9.35E-06,7.01E-02,10603.98032,2125605727,9.28E+13,69778314,978714489,10218148030,66637,103281,143361
108286,74485,14769,0.00860544,5.00E-04,69410187,550076,8065682710,1100068965,1599275934,1.19E+14,9165751675,4.30E-06,9.11E-03,6881.236547,1.74E+11,3.82E+13,69960263,1169479152,8066232786,2712140,43522,6490678
3171,21099,19275,0.00952101,0.17,637187,69137787,66904929,406683225,61121025,1.29E+12,473588154,0.00162,1.80E-01,98928.76134,2455644630,4.41E+13,69774974,407320412,136042716,17286,18773,68012
132100,23264,13456,0.00952101,0.17,29260806,53220839,3073174400,313040384,1777537600,4.14E+13,3386214784,0.00162,1.80E-01,2877072.055,393718848.8,1.56E+15,82481645,342301190,3126395239,1176448,835077,2656119
107295,31778,7864,0.00370564,0.15,12635158,37487381,3409620510,249902192,843767880,2.68E+13,3659522702,0.000556,1.54E-01,469005.001,49680136.41,4.74E+14,50122539,262537350,3447107891,277987,237578,643058
44771,25254,32024,0.00031941,0.03,361147,24262482,1130646834,808734096,1433746504,3.62E+13,1939380930,9.58E-06,3.03E-02,13738.58913,1503468762,8.76E+12,24623629,809095243,1154909316,41630,29508,93008
114605,33665,4450,0.00018467,0.13,712500,19477994,3858177325,149809250,509992250,1.72E+13,4007986575,2.40E-05,1.30E-01,12243.43494,95117362.48,1.39E+13,20190494,150521750,3877655319,17043,32547,35410
63715,68436,10651,0.00018467,0.03,805253,21869332,4360399740,728911836,678628465,4.64E+13,5089311576,5.54E-06,3.02E-02,3759.669559,257296745.9,1.76E+13,22674585,729717089,4382269072,32581,25191,71030
26325,35750,17002,0.02533638,0.03,23845342,18235635,941118750,607821500,447577650,1.60E+13,1548940250,0.00076,5.53E-02,340199.9226,1.01E+11,4.35E+14,42080977,631666842,959354385,587246,121879,2066795
119018,14162,14213,0.00860544,0.25,14505195,50322694,1685532916,201284506,1691602834,2.40E+13,1886817422,0.00215,2.59E-01,3639246.673,26800285919,7.30E+14,64827889,215789701,1735855610,597774,645215,1347029
73394,17955,3711,0.00370564,0.13,4883337,8662152,1317789270,66631005,272365134,4.89E+12,1384420275,0.000482,1.34E-01,131207.3276,4892872638,4.23E+13,13545489,71514342,1326451422,33572,47533,103571
23826,15472,23355,0.00160539,0.13,591831,46976946,368635872,361348560,556456230,8.61E+12,729984432,0.000209,1.32E-01,116132.8047,69107952.1,2.78E+13,47568777,361940391,415612818,37959,67740,79962
114703,29040,16272,0.00031941,0.005,1063952,2362756,3330975120,472538880,1866447216,5.42E+13,3803514000,1.60E-06,5.32E-03,2980.809526,2250630425,2.51E+12,3426708,473602832,3333337876,48103,7217,136892
46960,96358,2282,0.00015297,0.13,692201,28593912,4524971680,219888956,107162720,1.03E+13,4744860636,1.99E-05,1.30E-01,2131.048566,47386979.48,1.98E+13,29286113,220581157,4553565592,5308,16528,12778
140557,26521,9371,0.00163948,0.03,6111677,7456267,3727712197,248528291,1317159647,3.49E+13,3976240488,4.92E-05,3.16E-02,64783.70694,57270956.39,4.56E+13,13567944,254639968,3735168464,197458,109830,414880
61318,42558,3339,0.00952101,0.25,24845935,35531552,2609571444,142101162,204740802,8.71E+12,2751672606,0.00238,2.60E-01,487334.8058,41479989.33,8.83E+14,60377487,166947097,2645102996,131274,154909,426838
57227,97879,3251,0.00082487,0.2,4620380,63650089,5601321533,318204629,186044977,1.82E+13,5919526162,0.000165,2.01E-01,30692.58404,150207971.6,2.94E+14,68270469,322825009,5664971622,25713,48079,85959
19794,44616,39840,0.00160539,0.01,1417800,17775191,883129104,1777501440,788592960,3.52E+13,2660630544,1.61E-05,1.16E-02,12659.99252,282419113.1,2.52E+13,19192991,1778919240,900904295,93106,41731,318619
127804,26147,16108,0.00056263,0.03,1880173,12635909,3341691188,421175876,2058666832,5.38E+13,3762867064,1.69E-05,3.06E-02,34748.03159,7571306517,2.38E+13,14516082,423056049,3354327097,82144,75475,228748
133518,71453,1546,0.00019487,0.25,1859128,27626610,9540261654,110466338,206418828,1.47E+13,9650727992,4.87E-05,2.50E-01,10056.20925,201192969.5,5.14E+13,29485738,112325466,9567888264,19480,34962,23573
95903,7935,2916,0.00182521,0.07,1389096,1620205,760990305,23138460,279653148,2.22E+12,784128765,0.000128,7.18E-02,35729.80056,931552464.4,2.25E+12,3009301,24527556,762610510,9776,19684,27282
72726,4052,28920,0.00108175,0.23,318798,26954185,294685752,117183840,2103235920,8.52E+12,411869592,0.000249,2.31E-01,523290.355,2489132956,8.59E+12,27272983,117502638,321639937,38250,130033,70853
125584,13231,2924,0.00860544,0.03,14299146,1160701,1661601904,38687444,367207616,4.86E+12,1700289348,0.000258,3.86E-02,94799.49321,2090486824,1.66E+13,15459847,52986590,1662762605,122182,44544,284574
94334,44738,2079,0.00019487,0.17,822429,15812446,4220314492,93010302,196120386,8.77E+12,4313324794,3.31E-05,1.70E-01,6497.056535,8548979.861,1.30E+13,16634875,93832731,4236126938,4831,17100,14083
126662,25492,15720,0.00163948,0.005,5293748,2003809,3228867704,400734240,1991126640,5.08E+13,3629601944,8.20E-06,6.64E-03,16322.06152,16643279689,1.06E+13,7297557,406027988,3230871513,255206,31092,608529
79207,87813,2226,0.00015297,0.2,1063978,39100924,6955404291,195471738,176314782,1.55E+13,7150876029,3.06E-05,2.00E-01,5394.174441,307891116.1,4.16E+13,40164902,196535716,6994505215,6415,22120,19462
57651,2542,18422,0.00031941,0.13,46824,6089908,146548842,46828724,1062046722,2.70E+12,193377566,4.15E-05,1.30E-01,44099.68465,172463689.8,2.85E+11,6136732,46875548,152638750,10615,9383,16202
45263,13624,2693,0.00491597,0.2,3031624,7339353,616663112,36689432,121893259,1.66E+12,653352544,0.000983,2.05E-01,119844.7209,1061296910,2.23E+13,10370977,39721056,624002465,13981,24914,43331
15993,90923,22592,0.00491597,0.03,7148862,61625039,1454131539,2054132416,361313856,3.29E+13,3508263955,0.000147,3.49E-02,53286.2423,43604505078,4.41E+14,68773901,2061281278,1515756578,232800,81731,870520
28762,48643,7118,0.00082185,0.17,1149843,58867185,1399069966,346240874,204727916,9.96E+12,1745310840,0.00014,1.71E-01,28603.45842,1636891798,6.77E+13,60017028,347390717,1457937151,13951,30687,47673
54346,4104,9959,0.02533638,0.2,5651700,8175839,223035984,40871736,541231814,2.22E+12,263907720,0.00507,2.25E-01,2742570.982,56277556.54,4.62E+13,13827539,46523436,231211823,83767,117359,289034
62661,70597,5782,0.00031941,0.03,1412981,12246495,4423678617,408191854,362305902,2.56E+13,4831870471,9.58E-06,3.03E-02,3471.723845,2042444069,1.73E+13,13659476,409604835,4435925112,17020,20145,55340
107152,75023,1204,0.00160539,0.25,12905672,22588832,8038864496,90327692,129011008,9.68E+12,8129192188,0.000401,2.52E-01,51778.24553,155382372.6,2.92E+14,35494504,103233364,8061453328,42122,51412,114082
8374,58632,27284,0.01084252,0.01,5323816,15997806,490984368,1599715488,228476216,1.34E+13,2090699856,0.000108,2.08E-02,24772.57942,145246587.6,8.52E+13,21321622,1605039304,506982174,190089,33815,757744
20222,30795,11372,0.00013363,0.15,83218,52534062,622736490,350200740,229964584,7.08E+12,972937230,2.00E-05,1.50E-01,4609.525104,946335.5038,4.37E+12,52617280,350283958,675270552,6953,9928,30612
15333,43901,7034,0.00013363,0.2,89951,61765624,673134033,308799634,107852322,4.73E+12,981933667,2.67E-05,2.00E-01,2882.461158,3163573.182,5.56E+12,61855575,308889585,734899657,5155,8126,8200
26350,35302,46027,0.00031941,0.005,297128,8124377,930207700,1624845154,1212811450,4.28E+13,2555052854,1.60E-06,5.32E-03,1936.920526,410263010.5,2.41E+12,8421505,1625142282,938332077,48165,4737,108473
5352,1297,47635,0.00860544,0.03,59755,1853860,6941544,61782595,254942520,3.31E+11,68724139,0.000258,3.86E-02,65816.77678,369912224.4,1.11E+11,1913615,61842350,8795404,5811,5204,17714
126147,18767,270,0.00952101,0.13,22540844,660023,2367400749,5067090,34059690,6.39E+11,2372467839,0.00124,1.40E-01,42156.74438,1825743743,1.49E+13,23200867,27607934,2368060772,17765,10744,41453